64
1038
1034
0,0,0,0,0,0,0,0,0,0,0,0,0,0,0,0,0,0,0,0,0,0,0,0,0,0,0,0,0,0,0,0,0,0,0,0,0,0,0,0,0,0,0,0,0,0,0,0,0,0,0,0,0,0,0,0,0,0,0,0,0,0,0,0
0,1020,1020,1020,1020,1020,1020,1020,1020,1020,1020,1020,1020,1020,1020,1020,1020,1020,1020,1020,1020,1020,1020,1020,1020,1020,1020,1020,1020,1020,1020,1020,1020,1020,1020,1020,1020,1020,1020,1020,1020,1020,1020,1020,1020,1020,1020,1020,1020,0,0,0,0,0,0,0,0,0,0,0,0,0,0,0
0,1020,0,0,0,0,0,0,0,0,0,0,0,0,0,0,0,0,0,0,0,0,0,0,0,0,0,0,0,0,0,0,0,0,0,1020,0,0,0,0,0,0,0,0,0,0,0,5005,1020,0,0,0,0,0,0,0,0,0,0,0,0,0,0,0
0,1020,2036,0,0,0,0,0,0,0,0,0,0,0,0,0,0,0,0,2024,0,0,0,0,0,0,0,0,0,0,0,0,2034,0,0,1020,0,0,5004,0,0,0,5004,0,0,4003,0,0,1020,0,0,0,0,0,0,0,0,0,0,0,0,0,0,0
0,1020,0,0,1028,1028,1028,1028,1028,1028,1028,1028,0,0,0,1028,1028,1028,1028,1028,1028,1028,1028,0,0,0,0,0,0,0,0,0,0,0,0,1020,0,0,0,0,0,0,0,0,0,4009,0,5001,1020,0,0,0,0,0,0,0,0,0,0,0,0,0,0,0
0,1020,0,0,1028,0,0,0,0,0,4007,1028,0,0,0,1028,0,0,5007,0,0,5001,1028,0,0,0,0,0,0,0,0,0,0,0,0,3001,0,0,0,2043,0,0,0,0,0,4007,0,5001,1020,0,0,0,0,0,0,0,0,0,0,0,0,0,0,0
0,1020,0,0,1028,0,0,0,0,0,0,1028,0,0,0,1028,0,0,0,0,0,0,1028,0,0,0,5004,0,0,0,0,5004,0,0,0,1020,0,0,0,0,0,0,0,0,0,4007,0,0,1020,1020,1020,1020,1020,1020,1020,1020,1020,1020,0,0,0,0,0,0
0,1020,0,0,1028,0,4003,0,5004,0,0,3001,0,0,0,3001,0,0,5004,0,2044,0,1028,0,0,0,0,0,0,0,0,0,0,0,0,1020,0,0,5004,0,0,0,5004,0,0,0,0,0,1020,4002,0,0,5008,0,5005,5005,5005,1020,0,0,0,0,0,0
0,1020,0,0,1028,0,0,0,0,0,0,1028,0,0,0,1028,0,0,0,0,0,0,1028,0,0,0,0,0,0,0,0,0,0,0,0,1020,0,0,0,0,0,0,0,0,0,0,0,5005,1020,4007,0,5008,0,0,0,0,5005,1020,0,0,0,0,0,0
0,1020,0,0,1028,0,0,0,0,0,4007,1028,0,0,0,1028,5007,0,0,5007,0,5001,1028,0,0,0,0,0,0,0,0,0,0,0,0,1020,1020,1020,1020,1020,1020,1020,1020,1020,1020,1020,1020,1020,1020,0,0,0,0,5004,5008,0,5005,1020,0,0,0,0,0,0
0,1020,0,0,1028,1028,1028,1028,1028,1028,1028,1028,0,0,0,1028,1028,1028,1028,1028,1028,1028,1028,0,0,0,0,0,0,0,0,0,0,0,0,1020,4001,0,0,0,0,0,0,1020,0,0,0,0,0,0,0,0,0,0,0,0,0,1020,0,0,0,0,0,0
0,1020,0,0,0,0,0,0,0,0,0,0,0,0,0,0,0,0,0,0,0,0,0,0,0,0,0,0,0,0,0,0,0,0,0,1020,0,0,0,0,0,0,0,1020,0,2033,0,5008,0,0,2015,0,5008,0,5008,2036,0,1020,0,0,0,0,0,0
0,1020,0,0,0,0,0,0,0,0,0,0,0,0,0,0,0,0,0,0,0,0,0,0,0,0,0,0,0,0,0,0,0,0,5003,1020,0,0,0,0,0,0,0,1020,0,0,0,0,0,0,0,0,0,0,0,0,5008,1020,0,0,0,0,0,0
0,1020,0,0,1028,1028,1028,1028,1028,1028,1028,1028,0,0,0,1028,1028,1028,1028,1028,1028,1028,1028,0,0,0,0,0,0,0,0,0,0,0,0,1020,0,0,0,0,0,0,0,1020,0,0,0,5004,0,0,0,0,0,0,5004,2014,0,1020,0,0,0,0,0,0
0,1020,0,0,1028,5001,0,0,5007,0,4007,1028,0,0,0,1028,4007,0,0,0,0,0,1028,0,0,0,0,0,0,0,0,0,0,0,0,1020,0,0,0,0,0,0,2004,1020,0,0,0,0,0,0,5008,0,0,0,0,0,0,1020,0,0,0,0,0,0
0,1020,0,0,1028,0,0,0,0,0,0,1028,5007,0,0,1028,0,0,0,0,0,0,1028,0,0,0,0,0,0,0,0,0,0,0,0,3001,0,0,0,5004,0,0,0,3005,0,0,0,0,0,0,0,0,0,0,0,5008,0,1020,0,0,0,0,0,0
0,1020,0,0,1028,0,4009,5004,2027,0,0,3001,5007,5007,0,3001,0,0,5004,0,4003,0,1028,0,0,0,5004,0,0,0,0,5004,0,0,0,1020,0,0,0,0,0,0,2004,1020,0,0,0,0,0,0,0,0,0,0,0,0,0,1020,0,0,0,0,0,0
0,1020,0,0,1028,0,0,5007,0,0,0,1028,5007,0,0,1028,0,0,0,0,0,0,1028,0,0,0,0,0,0,0,0,0,0,0,0,1020,0,0,0,0,0,0,0,1020,0,2013,0,5004,0,0,0,0,0,0,5004,0,0,1020,0,0,0,0,0,0
0,1020,0,0,1028,5001,0,0,0,0,4003,1028,0,0,0,1028,4007,0,0,0,0,0,1028,0,0,0,0,0,0,0,0,0,0,0,5003,1020,0,0,0,0,0,0,0,1020,0,2035,0,0,0,0,0,0,0,0,0,2034,0,1020,0,0,0,0,0,0
0,1020,0,0,1028,1028,1028,1028,1028,1028,1028,1028,0,0,0,1028,1028,1028,1028,1028,1028,1028,1028,0,0,0,0,0,0,0,0,0,0,0,0,1020,4001,0,0,0,0,0,0,1020,0,0,0,0,0,0,0,0,0,0,0,0,0,1020,0,0,0,0,0,0
0,1020,0,0,0,0,0,0,0,0,0,0,0,5007,0,0,0,0,0,0,0,0,0,0,0,0,0,0,0,0,0,0,0,0,0,1020,1020,1020,1020,1020,1020,1020,1020,1020,1020,1020,1020,1020,1020,1020,1020,1020,1020,1020,3006,1020,1020,1020,0,0,0,0,0,0
0,1020,0,0,0,0,0,0,0,0,0,0,0,0,0,0,0,0,0,0,0,0,0,0,0,0,0,0,0,0,0,0,0,0,0,1020,0,0,0,0,0,0,0,0,0,0,0,0,0,0,0,1020,0,0,0,0,0,1020,0,0,0,0,0,0
0,1020,0,0,1028,1028,1028,1028,1028,1028,1028,1028,0,0,0,1028,1028,1028,1028,1028,1028,1028,1028,0,0,0,0,0,0,0,0,0,0,0,0,1020,0,0,0,0,0,0,0,0,0,0,0,0,0,0,0,1020,0,0,2025,0,0,1020,0,0,0,0,0,0
0,1020,0,0,1028,5001,0,0,0,0,0,1028,0,0,0,1028,4007,0,0,0,0,0,1028,0,0,0,0,0,0,0,0,0,0,0,0,1020,0,0,0,0,0,0,0,0,0,0,0,0,0,0,0,1020,0,0,0,0,0,1020,0,0,0,0,0,0
0,1020,0,0,1028,0,0,0,0,0,0,1028,0,0,0,1028,0,0,0,0,0,0,1028,0,0,0,0,0,0,0,0,0,0,0,0,1020,0,0,0,0,0,0,0,0,0,0,0,0,0,0,0,1020,0,0,5004,0,0,1020,0,0,0,0,0,0
0,1020,0,0,1028,0,0,2043,5004,0,0,3001,0,0,0,3001,0,0,5004,0,4003,0,1028,0,0,0,5004,0,0,0,0,5004,0,0,0,1020,0,0,0,0,0,0,0,0,0,0,0,0,0,0,0,1020,0,0,0,0,0,1020,0,0,0,0,0,0
0,1020,0,0,1028,0,0,0,0,0,0,1028,0,0,0,1028,0,0,0,0,0,0,1028,0,0,0,0,0,0,0,0,0,0,0,0,1020,0,0,0,0,0,0,0,0,0,0,0,0,0,0,0,1020,0,0,0,0,0,1020,0,0,0,0,0,0
0,1020,0,0,1028,5001,0,0,0,0,0,1028,0,0,0,1028,4007,0,0,0,0,0,1028,0,0,0,0,0,0,0,0,0,0,0,0,1020,0,0,0,0,0,0,0,0,0,0,0,0,0,0,0,1020,0,1012,3002,1012,0,1020,0,0,0,0,0,0
0,1020,0,0,1028,1028,1028,1028,1028,1028,1028,1028,0,0,0,1028,1028,1028,1028,1028,1028,1028,1028,0,0,0,0,0,0,0,0,0,0,0,0,1020,0,0,1025,1025,1025,1025,1025,1025,1025,1025,1025,1025,0,0,0,1020,0,1012,4011,1012,0,1020,0,0,0,0,0,0
0,1020,0,0,0,5007,0,0,0,0,0,0,0,5007,0,0,0,0,0,0,0,0,0,0,0,0,0,0,0,0,0,0,0,0,0,1020,0,0,1025,0,0,0,0,0,0,0,0,1025,0,0,0,1020,1020,1012,1012,1012,1020,1020,0,0,0,0,0,0
0,1020,2033,0,0,0,0,0,0,0,0,0,0,0,0,0,0,2023,0,0,0,0,0,0,0,0,0,0,0,0,0,0,2035,0,0,1020,0,0,1025,0,2036,0,0,0,0,2034,0,1025,0,0,0,0,0,0,0,0,0,0,0,0,0,0,0,0
0,1020,1020,1020,0,0,0,1020,1020,1020,1020,1020,1020,1020,1020,1020,1020,1020,1020,1020,1020,1020,1020,1020,1020,1020,1020,1020,1020,1020,1020,1020,1020,1020,1020,1020,0,0,1025,0,0,0,5004,0,0,0,0,1025,0,0,0,0,0,0,0,0,0,0,0,0,0,0,0,0
0,1025,1025,1025,1025,3002,1025,1025,1025,1025,1025,1025,1025,1025,1025,1025,1025,1025,1025,1025,1025,1025,1025,1025,1025,1025,1025,1025,1025,1025,1025,1025,1025,1025,1025,1025,1025,1025,1025,0,2014,0,0,0,0,0,0,1025,1025,1025,1025,1025,1025,1025,1025,1025,1025,1025,1025,1025,0,0,0,0
0,1025,0,5002,0,0,0,5002,0,0,1025,0,0,0,0,0,0,0,0,0,0,0,1025,0,0,0,1025,0,0,0,0,0,0,0,0,0,0,0,1025,0,0,0,0,0,0,0,0,1025,0,0,0,0,0,0,0,0,0,0,0,1025,0,0,0,0
0,1025,0,2033,0,2015,0,0,2040,0,3001,0,0,0,5004,0,0,0,0,0,5004,0,1025,0,4002,0,1025,0,5004,0,0,0,0,0,0,5004,0,0,3001,0,0,0,0,0,0,0,0,3001,0,2036,0,0,2008,0,0,5004,0,2034,0,1025,0,0,0,0
0,1025,0,0,0,0,0,0,0,0,1025,0,0,0,0,0,0,2003,0,0,0,0,1025,0,0,0,1025,0,0,0,2004,0,0,0,0,0,0,0,1025,0,0,0,0,0,0,0,0,1025,0,2033,0,0,0,0,2036,0,0,0,0,1025,0,0,0,0
0,1025,0,0,0,5004,0,0,0,0,1025,1025,1025,1025,1025,1025,1025,1025,0,0,0,0,1025,0,2018,0,1025,0,0,0,1025,1025,1025,1025,1025,1025,1025,1025,1025,0,0,0,5004,0,0,0,0,1025,0,0,0,0,0,0,0,0,0,0,0,1025,0,0,0,0
0,1025,0,0,0,0,0,0,0,0,1025,0,0,0,0,0,0,1025,0,0,0,0,1025,0,5004,0,1025,0,0,0,1025,0,0,0,0,0,0,0,1025,0,0,0,0,0,0,0,0,1025,1025,1025,1025,1025,1025,0,0,0,0,2005,0,1025,0,0,0,0
0,1025,0,2038,0,0,0,0,2039,0,1025,0,0,0,0,0,0,1025,0,0,0,0,1025,0,0,0,1025,0,5004,0,1025,0,0,0,0,0,0,0,1025,0,0,0,0,0,0,0,0,1025,0,0,0,0,1025,0,0,0,0,0,0,1025,0,0,0,0
0,1025,0,0,0,0,0,0,0,0,1025,0,0,0,0,0,0,1025,0,0,5004,0,1025,0,0,0,1025,0,0,0,1025,0,0,0,0,0,0,0,1025,0,0,0,0,0,0,0,0,1025,0,0,0,0,1025,0,0,0,0,0,0,1025,0,0,0,0
0,1025,0,0,0,0,5007,0,0,0,1025,0,0,0,0,0,0,1025,0,0,0,0,1025,0,0,0,1025,0,0,0,1025,0,0,0,0,0,0,0,1025,0,0,0,0,0,0,0,0,1025,0,0,0,0,1025,0,0,0,0,0,0,1025,0,0,0,0
0,1025,0,0,0,0,0,0,0,0,1025,0,0,0,0,0,1023,1023,1023,3004,1023,1023,1023,1023,3002,1023,1023,1023,3002,1023,1023,1023,0,0,0,0,0,0,1025,0,0,0,5004,0,0,2013,0,1025,0,0,0,0,1025,0,0,0,0,0,0,1025,0,0,0,0
0,1025,0,2037,0,5004,0,0,0,0,1025,0,0,0,0,0,1023,0,0,0,0,0,5002,0,0,0,5002,0,0,0,5003,1023,0,0,0,0,0,0,1025,0,0,0,0,0,0,0,0,1025,0,0,0,0,1025,0,0,5004,0,0,0,1025,0,0,0,0
0,1025,0,0,0,0,0,0,2040,0,1025,0,0,0,0,0,1023,0,2036,0,0,0,0,0,0,0,0,0,0,2034,0,1023,0,0,0,0,0,0,1025,0,2033,0,0,0,0,2035,0,1025,0,0,0,0,1025,0,0,0,0,0,0,1025,0,0,0,0
0,1025,0,2013,0,0,0,0,0,0,1025,0,0,0,0,0,1023,0,2010,0,5004,0,0,0,0,0,0,5004,0,0,0,1023,0,0,0,0,0,0,1025,4007,0,0,0,0,0,0,4002,1025,0,0,0,0,1025,0,0,0,0,0,0,1025,0,0,0,0
0,1025,0,0,0,0,0,0,0,0,1025,0,0,0,0,0,1023,0,0,0,0,0,0,0,0,0,0,0,0,2013,0,1023,0,0,0,0,0,0,1025,1025,1025,1025,1025,1025,1025,1025,1025,1025,0,0,0,0,1025,0,0,0,0,0,0,1025,0,0,0,0
0,1025,0,0,5007,0,0,0,2039,0,1025,0,0,0,0,0,1023,0,2033,0,0,0,0,0,0,0,0,0,0,2035,0,1023,0,0,0,0,0,0,0,0,0,0,0,0,0,0,0,0,0,0,0,0,1025,0,0,0,0,0,0,1025,0,0,0,0
0,1025,0,2038,0,0,0,0,0,0,1025,0,0,0,0,0,1023,0,0,0,0,0,0,0,0,0,0,0,0,0,0,1023,0,0,0,0,0,0,0,0,0,0,0,0,0,0,0,0,0,0,0,0,1025,0,0,0,0,2013,0,1025,0,0,0,0
0,1025,0,0,0,5004,0,0,0,0,1025,0,0,0,0,0,1023,1023,1023,1023,1023,1023,1023,1023,3002,1023,1023,1023,1023,1023,1023,1023,0,0,0,0,0,0,0,0,0,0,0,0,0,0,0,0,0,0,0,0,1025,0,2006,0,0,0,0,1025,0,0,0,0
0,1025,0,0,0,0,0,0,0,0,1025,0,0,0,0,0,0,0,0,0,0,0,1023,2002,0,2002,1023,0,0,0,0,0,0,0,0,0,0,0,0,0,0,0,0,0,0,0,0,0,0,0,0,0,1025,0,0,0,0,0,0,1025,0,0,0,0
0,1025,0,2037,0,2016,2034,0,0,0,1025,0,0,0,0,0,0,0,0,0,0,0,1023,0,0,0,1023,0,0,0,0,0,0,0,0,0,0,0,0,0,0,0,0,0,0,0,0,0,0,0,0,0,1025,0,0,0,0,0,0,1025,0,0,0,0
0,1025,4007,0,0,0,0,0,0,4003,1025,0,0,0,0,0,0,0,0,0,0,0,1023,0,0,0,1023,0,0,0,0,0,0,0,0,0,0,0,0,0,0,0,0,0,0,1025,1025,1025,1025,1025,1025,1025,1025,0,0,0,0,0,0,1025,0,0,0,0
0,1025,1025,1025,1025,1025,1025,1025,1025,1025,1025,0,0,0,0,0,0,0,0,0,0,0,1023,0,5004,0,1023,0,0,0,0,0,0,0,0,0,0,0,0,0,0,0,0,0,0,1025,0,0,0,0,0,5001,1025,0,0,5004,0,0,0,1025,0,0,0,0
0,0,0,0,0,0,0,0,0,0,0,0,0,0,0,0,0,0,0,0,0,0,1023,0,0,0,1023,0,0,0,0,0,0,0,0,0,0,0,0,0,0,0,0,0,0,1025,0,2018,4008,2018,0,0,1025,0,2033,0,0,2035,0,1025,0,0,0,0
0,0,0,0,0,0,0,1023,1023,1023,1023,1023,1023,1023,1023,1023,0,0,0,0,0,0,1023,0,0,0,1023,0,0,0,0,0,0,1023,1023,1023,1023,1023,1023,1023,1023,1023,0,0,0,1025,0,0,0,0,0,5007,1025,0,0,0,0,0,0,1025,0,0,0,0
0,0,0,0,0,0,0,1023,5005,0,0,5008,0,0,0,1023,0,0,0,0,0,0,1023,0,0,0,1023,0,0,0,0,0,0,1023,0,0,5008,0,0,0,5005,1023,0,0,0,1025,0,0,5004,0,0,0,1025,0,5003,0,0,0,5003,1025,0,0,0,0
0,0,0,0,0,0,0,1023,0,0,4002,0,0,4007,0,1023,1023,1023,1023,1023,1023,1023,1023,0,0,0,1023,1023,1023,1023,1023,1023,1023,1023,0,4007,0,0,4002,0,0,1023,0,0,0,1025,5007,0,0,0,0,0,1025,1025,1025,1025,3002,1025,1025,1025,0,0,0,0
0,0,0,0,0,0,0,1023,5008,0,0,0,0,0,0,1023,0,0,0,0,0,0,0,0,0,0,0,0,0,0,0,0,0,1023,0,0,0,0,0,5008,0,1023,0,0,0,1025,0,0,0,0,0,0,0,0,0,0,0,0,4003,1025,0,0,0,0
0,0,0,0,0,0,0,1023,0,0,0,5004,0,0,2011,3001,0,0,5004,0,0,0,0,0,5004,0,0,0,0,0,5004,0,0,3001,2012,0,0,5004,0,0,0,1023,0,0,0,1025,0,0,0,0,5007,0,0,0,5007,0,5001,0,4007,1025,0,0,0,0
0,0,0,0,0,0,0,1023,5005,0,5008,0,0,0,0,1023,0,0,0,0,0,0,0,0,0,0,0,0,0,0,0,0,0,1023,0,0,0,0,5008,0,5005,1023,0,0,0,1025,0,0,5004,0,0,0,0,0,5004,0,0,0,0,1025,0,0,0,0
0,0,0,0,0,0,0,1023,1023,1023,1023,1023,1023,1023,1023,1023,1023,1023,1023,1023,1023,1023,1023,1023,3002,1023,1023,1023,1023,1023,1023,1023,1023,1023,1023,1023,1023,1023,1023,1023,1023,1023,0,0,0,1025,0,0,0,0,0,0,5007,0,0,0,5007,0,0,1025,0,0,0,0
0,0,0,0,0,0,0,0,0,0,0,0,0,0,0,0,0,0,0,0,0,1023,0,0,0,0,0,1023,0,0,0,0,0,0,0,0,0,0,0,0,0,0,0,0,0,1025,0,0,0,0,0,0,0,0,0,0,0,0,0,1025,0,0,0,0
0,0,0,0,0,0,0,0,0,0,0,0,0,0,0,0,0,0,0,0,0,1023,0,0,4010,0,0,1023,0,0,0,0,0,0,0,0,0,0,0,0,0,0,0,0,0,1025,1025,1025,1025,1025,1025,1025,1025,1025,1025,1025,1025,1025,1025,1025,0,0,0,0
0,0,0,0,0,0,0,0,0,0,0,0,0,0,0,0,0,0,0,0,0,1023,1023,1023,1023,1023,1023,1023,0,0,0,0,0,0,0,0,0,0,0,0,0,0,0,0,0,0,0,0,0,0,0,0,0,0,0,0,0,0,0,0,0,0,0,0

0,0,0,0,0,0,0,0,0,0,0,0,0,0,0,0,0,0,0,0,0,0,0,0,0,0,0,0,0,0,0,0,0,0,0,0,0,0,0,0,0,0,0,0,0,0,0,0,0,0,0,0,0,0,0,0,0,0,0,0,0,0,0,0
0,0,0,0,0,0,0,0,0,0,0,0,0,0,0,0,0,0,0,0,0,0,0,0,0,0,0,0,0,0,0,0,0,0,0,0,0,0,0,0,0,0,0,0,0,0,0,0,0,0,0,0,0,0,0,0,0,0,0,0,0,0,0,0
0,0,9013,9013,9013,9013,9013,9013,9013,9013,9013,9013,9013,9013,9013,9013,9013,9013,9013,9013,9013,9013,9013,9013,9013,9013,9013,9013,9013,9013,9013,9013,9013,9013,9013,0,9021,9021,9021,9021,9021,9021,9021,9021,9021,9021,9021,9021,0,0,0,0,0,0,0,0,0,0,0,0,0,0,0,0
0,0,9013,9013,9013,9013,9013,9013,9013,9013,9013,9013,9013,9013,9013,9013,9013,9013,9013,9013,9013,9013,9013,9013,9013,9013,9013,9013,9013,9013,9013,9013,9013,9013,9013,0,9021,9021,9021,9021,9021,9021,9021,9021,9021,9021,9021,9021,0,0,0,0,0,0,0,0,0,0,0,0,0,0,0,0
0,0,9013,9013,0,0,0,0,0,0,0,0,9013,9013,9013,0,0,0,0,0,0,0,0,9013,9013,9013,9013,9013,9013,9013,9013,9013,9013,9013,9013,0,9021,9021,9021,9021,9021,9021,9021,9021,9021,9021,9021,9021,0,0,0,0,0,0,0,0,0,0,0,0,0,0,0,0
0,0,9013,9013,0,9019,9019,9019,9019,9019,9019,0,9013,9013,9013,0,9018,9018,9018,9018,9018,9018,0,9013,9013,9013,9013,9013,9013,9013,9013,9013,9013,9013,9013,0,9021,9021,9021,9021,9021,9021,9021,9021,9021,9021,9021,9021,0,0,0,0,0,0,0,0,0,0,0,0,0,0,0,0
0,0,9013,9013,0,9019,9019,9019,9019,9019,9019,0,9013,9013,9013,0,9018,9018,9018,9018,9018,9018,0,9013,9013,9013,9013,9013,9013,9013,9013,9013,9013,9013,9013,0,9021,9021,9021,9021,9021,9021,9021,9021,9021,9021,9021,9021,0,0,0,0,0,0,0,0,0,0,0,0,0,0,0,0
0,0,9013,9013,0,9019,9019,9019,9019,9019,9019,0,9013,9013,9013,0,9018,9018,9018,9018,9018,9018,0,9013,9013,9013,9013,9013,9013,9013,9013,9013,9013,9013,9013,0,9021,9021,9021,9021,9021,9021,9021,9021,9021,9021,9021,9021,0,9022,9022,9022,9022,9022,9022,9022,9022,0,0,0,0,0,0,0
0,0,9013,9013,0,9019,9019,9019,9019,9019,9019,0,9013,9013,9013,0,9018,9018,9018,9018,9018,9018,0,9013,9013,9013,9013,9013,9013,9013,9013,9013,9013,9013,9013,0,9021,9021,9021,9021,9021,9021,9021,9021,9021,9021,9021,9021,0,9022,9022,9022,9022,9022,9022,9022,9022,0,0,0,0,0,0,0
0,0,9013,9013,0,9019,9019,9019,9019,9019,9019,0,9013,9013,9013,0,9018,9018,9018,9018,9018,9018,0,9013,9013,9013,9013,9013,9013,9013,9013,9013,9013,9013,9013,0,0,0,0,0,0,0,0,0,0,0,0,0,0,9022,9022,9022,9022,9022,9022,9022,9022,0,0,0,0,0,0,0
0,0,9013,9013,0,0,0,0,0,0,0,0,9013,9013,9013,0,0,0,0,0,0,0,0,9013,9013,9013,9013,9013,9013,9013,9013,9013,9013,9013,9013,0,9020,9020,9020,9020,9020,9020,9020,0,9022,9022,9022,9022,9022,9022,9022,9022,9022,9022,9022,9022,9022,0,0,0,0,0,0,0
0,0,9013,9013,9013,9013,9013,9013,9013,9013,9013,9013,9013,9013,9013,9013,9013,9013,9013,9013,9013,9013,9013,9013,9013,9013,9013,9013,9013,9013,9013,9013,9013,9013,9013,0,9020,9020,9020,9020,9020,9020,9020,0,9022,9022,9022,9022,9022,9022,9022,9022,9022,9022,9022,9022,9022,0,0,0,0,0,0,0
0,0,9013,9013,9013,9013,9013,9013,9013,9013,9013,9013,9013,9013,9013,9013,9013,9013,9013,9013,9013,9013,9013,9013,9013,9013,9013,9013,9013,9013,9013,9013,9013,9013,9013,0,9020,9020,9020,9020,9020,9020,9020,0,9022,9022,9022,9022,9022,9022,9022,9022,9022,9022,9022,9022,9022,0,0,0,0,0,0,0
0,0,9013,9013,0,0,0,0,0,0,0,0,9013,9013,9013,0,0,0,0,0,0,0,0,9013,9013,9013,9013,9013,9013,9013,9013,9013,9013,9013,9013,0,9020,9020,9020,9020,9020,9020,9020,0,9022,9022,9022,9022,9022,9022,9022,9022,9022,9022,9022,9022,9022,0,0,0,0,0,0,0
0,0,9013,9013,0,9017,9017,9017,9017,9017,9017,0,9013,9013,9013,0,9016,9016,9016,9016,9016,9016,0,9013,9013,9013,9013,9013,9013,9013,9013,9013,9013,9013,9013,0,9020,9020,9020,9020,9020,9020,9020,0,9022,9022,9022,9022,9022,9022,9022,9022,9022,9022,9022,9022,9022,0,0,0,0,0,0,0
0,0,9013,9013,0,9017,9017,9017,9017,9017,9017,0,9013,9013,9013,0,9016,9016,9016,9016,9016,9016,0,9013,9013,9013,9013,9013,9013,9013,9013,9013,9013,9013,9013,0,9020,9020,9020,9020,9020,9020,9020,0,9022,9022,9022,9022,9022,9022,9022,9022,9022,9022,9022,9022,9022,0,0,0,0,0,0,0
0,0,9013,9013,0,9017,9017,9017,9017,9017,9017,0,9013,9013,9013,0,9016,9016,9016,9016,9016,9016,0,9013,9013,9013,9013,9013,9013,9013,9013,9013,9013,9013,9013,0,9020,9020,9020,9020,9020,9020,9020,0,9022,9022,9022,9022,9022,9022,9022,9022,9022,9022,9022,9022,9022,0,0,0,0,0,0,0
0,0,9013,9013,0,9017,9017,9017,9017,9017,9017,0,9013,9013,9013,0,9016,9016,9016,9016,9016,9016,0,9013,9013,9013,9013,9013,9013,9013,9013,9013,9013,9013,9013,0,9020,9020,9020,9020,9020,9020,9020,0,9022,9022,9022,9022,9022,9022,9022,9022,9022,9022,9022,9022,9022,9016,0,0,0,0,0,0
0,0,9013,9013,0,9017,9017,9017,9017,9017,9017,0,9013,9013,9013,0,9016,9016,9016,9016,9016,9016,0,9013,9013,9013,9013,9013,9013,9013,9013,9013,9013,9013,9013,0,9020,9020,9020,9020,9020,9020,9020,0,9022,9022,9022,9022,9022,9022,9022,9022,9022,9022,9022,9022,9022,0,0,0,0,0,0,0
0,0,9013,9013,0,0,0,0,0,0,0,0,9013,9013,9013,0,0,0,0,0,0,0,0,9013,9013,9013,9013,9013,9013,9013,9013,9013,9013,9013,9013,0,9020,9020,9020,9020,9020,9020,9020,0,9022,9022,9022,9022,9022,9022,9022,9022,9022,9022,9022,9022,9022,0,0,0,0,0,0,0
0,0,9013,9013,9013,9013,9013,9013,9013,9013,9013,9013,9013,9013,9013,9013,9013,9013,9013,9013,9013,9013,9013,9013,9013,9013,9013,9013,9013,9013,9013,9013,9013,9013,9013,0,0,0,0,0,0,0,0,0,0,0,0,0,0,0,0,0,0,0,0,0,0,0,0,0,0,0,0,0
0,0,9013,9013,9013,9013,9013,9013,9013,9013,9013,9013,9013,9013,9013,9013,9013,9013,9013,9013,9013,9013,9013,9013,9013,9013,9013,9013,9013,9013,9013,9013,9013,9013,9013,0,0,0,0,0,0,0,0,0,0,0,0,0,0,0,0,0,9023,9023,9023,9023,9023,0,0,0,0,0,0,0
0,0,9013,9013,0,0,0,0,0,0,0,0,9013,9013,9013,0,0,0,0,0,0,0,0,9013,9013,9013,9013,9013,9013,9013,9013,9013,9013,9013,9013,0,0,0,0,0,0,0,0,0,0,0,0,0,0,0,0,0,9023,9023,9023,9023,9023,0,0,0,0,0,0,0
0,0,9013,9013,0,9014,9014,9014,9014,9014,9014,0,9013,9013,9013,0,9015,9015,9015,9015,9015,9015,0,9013,9013,9013,9013,9013,9013,9013,9013,9013,9013,9013,9013,0,0,0,0,0,0,0,0,0,0,0,0,0,0,0,0,0,9023,9023,9023,9023,9023,0,0,0,0,0,0,0
0,0,9013,9013,0,9014,9014,9014,9014,9014,9014,0,9013,9013,9013,0,9015,9015,9015,9015,9015,9015,0,9013,9013,9013,9013,9013,9013,9013,9013,9013,9013,9013,9013,0,0,0,0,0,0,0,0,0,0,0,0,0,0,0,0,0,9023,9023,9023,9023,9023,0,0,0,0,0,0,0
0,0,9013,9013,0,9014,9014,9014,9014,9014,9014,0,9013,9013,9013,0,9015,9015,9015,9015,9015,9015,0,9013,9013,9013,9013,9013,9013,9013,9013,9013,9013,9013,9013,0,0,0,0,0,0,0,0,0,0,0,0,0,0,0,0,0,9023,9023,9023,9023,9023,0,0,0,0,0,0,0
0,0,9013,9013,0,9014,9014,9014,9014,9014,9014,0,9013,9013,9013,0,9015,9015,9015,9015,9015,9015,0,9013,9013,9013,9013,9013,9013,9013,9013,9013,9013,9013,9013,0,0,0,0,0,0,0,0,0,0,0,0,0,0,0,0,0,9023,9023,9023,9023,9023,0,0,0,0,0,0,0
0,0,9013,9013,0,9014,9014,9014,9014,9014,9014,0,9013,9013,9013,0,9015,9015,9015,9015,9015,9015,0,9013,9013,9013,9013,9013,9013,9013,9013,9013,9013,9013,9013,0,0,0,0,0,0,0,0,0,0,0,0,0,0,0,0,0,9023,0,0,0,9023,0,0,0,0,0,0,0
0,0,9013,9013,0,0,0,0,0,0,0,0,9013,9013,9013,0,0,0,0,0,0,0,0,9013,9013,9013,9013,9013,9013,9013,9013,9013,9013,9013,9013,0,0,0,0,0,0,0,0,0,0,0,0,0,0,0,0,0,9023,0,0,0,9023,0,0,0,0,0,0,0
0,0,9013,9013,9013,9013,9013,9013,9013,9013,9013,9013,9013,9013,9013,9013,9013,9013,9013,9013,9013,9013,9013,9013,9013,9013,9013,9013,9013,9013,9013,9013,9013,9013,9013,0,0,0,0,9008,9008,9008,9008,9008,9008,9008,9008,0,0,0,0,0,0,0,0,0,0,0,0,0,0,0,0,0
0,0,9013,9013,9013,9013,9013,9013,9013,9013,9013,9013,9013,9013,9013,9013,9013,9013,9013,9013,9013,9013,9013,9013,9013,9013,9013,9013,9013,9013,9013,9013,9013,9013,9013,0,0,0,0,9008,9008,9008,9008,9008,9008,9008,9008,0,0,0,0,0,0,0,0,0,0,0,0,0,0,0,0,0
0,0,0,0,9013,9013,9013,0,0,0,0,0,0,0,0,0,0,0,0,0,0,0,0,0,0,0,0,0,0,0,0,0,0,0,0,0,0,0,0,9008,9008,9008,9008,9008,9008,9008,9008,0,0,0,0,0,0,0,0,0,0,0,0,0,0,0,0,0
0,0,0,0,0,0,0,0,0,0,0,0,0,0,0,0,0,0,0,0,0,0,0,0,0,0,0,0,0,0,0,0,0,0,0,0,0,0,0,9008,9008,9008,9008,9008,9008,9008,9008,0,0,0,0,0,0,0,0,0,0,0,0,0,0,0,0,0
0,0,9012,9012,9012,9012,9012,9012,9012,9012,0,9011,9011,9011,9011,9011,9011,9011,9011,9011,9011,9011,0,9006,9006,9006,0,9007,9007,9007,9007,9007,9007,9007,9007,9007,9007,9007,0,9008,9008,9008,9008,9008,9008,9008,9008,0,9009,9009,9009,9009,9009,9009,0,9009,9009,9009,9009,0,0,0,0,0
0,0,9012,9012,9012,9012,9012,9012,9012,9012,0,9011,9011,9011,9011,9011,9011,9011,9011,9011,9011,9011,0,9006,9006,9006,0,9007,9007,9007,9007,9007,9007,9007,9007,9007,9007,9007,0,9008,9008,9008,9008,9008,9008,9008,9008,0,9009,9009,9009,9009,9009,9009,9009,9009,9009,9009,9009,0,0,0,0,0
0,0,9012,9012,9012,9012,9012,9012,9012,9012,0,9011,9011,9011,9011,9011,9011,9011,9011,9011,9011,9011,0,9006,9006,9006,0,9007,9007,9007,9007,9007,9007,9007,9007,9007,9007,9007,0,9008,9008,9008,9008,9008,9008,9008,9008,0,9009,9009,9009,9009,9009,0,9009,9009,9009,9009,9009,0,0,0,0,0
0,0,9012,9012,9012,9012,9012,9012,9012,9012,0,0,0,0,0,0,0,0,9011,9011,9011,9011,0,9006,9006,9006,0,9007,9007,9007,0,0,0,0,0,0,0,0,0,9008,9008,9008,9008,9008,9008,9008,9008,0,9009,9009,9009,9009,9009,9009,9009,9009,9009,9009,9009,0,0,0,0,0
0,0,9012,9012,9012,9012,9012,9012,9012,9012,0,0,0,0,0,0,0,0,9011,9011,9011,9011,0,9006,9006,9006,0,9007,9007,9007,0,0,0,0,0,0,0,0,0,9008,9008,9008,9008,9008,9008,9008,9008,0,0,0,0,0,0,9009,9009,9009,9009,9009,9009,0,0,0,0,0
0,0,9012,9012,9012,9012,9012,9012,9012,9012,0,0,0,0,0,0,0,0,9011,9011,9011,9011,0,9006,9006,9006,0,9007,9007,9007,0,0,0,0,0,0,0,0,0,9008,9008,9008,9008,9008,9008,9008,9008,0,0,0,0,0,0,9009,9009,9009,9009,9009,9009,0,0,0,0,0
0,0,9012,9012,9012,9012,9012,9012,9012,9012,0,0,0,0,0,0,0,0,9011,9011,9011,9011,0,9006,9006,9006,0,9007,9007,9007,0,0,0,0,0,0,0,0,0,9008,9008,9008,9008,9008,9008,9008,9008,0,0,0,0,0,0,9009,9009,9009,9009,9009,9009,0,0,0,0,0
0,0,9012,9012,9012,9012,9012,9012,9012,9012,0,0,0,0,0,0,0,0,9011,9011,9011,9011,0,9006,9006,9006,0,9007,9007,9007,0,0,0,0,0,0,0,0,0,9008,9008,9008,9008,9008,9008,9008,9008,0,0,0,0,0,0,9009,9009,9009,9009,9009,9009,0,0,0,0,0
0,0,9012,9012,9012,9012,9012,9012,9012,9012,0,0,0,0,0,0,0,0,0,0,0,0,0,0,0,0,0,0,0,0,0,0,0,0,0,0,0,0,0,9008,9008,9008,9008,9008,9008,9008,9008,0,0,0,0,0,0,9009,9009,9009,9009,9009,9009,0,0,0,0,0
0,0,9012,9012,9012,9012,9012,9012,9012,9012,0,0,0,0,0,0,0,9005,9005,9005,9005,9005,9005,9005,9005,9005,9005,9005,9005,9005,9005,0,0,0,0,0,0,0,0,9008,9008,9008,9008,9008,9008,9008,9008,0,0,0,0,0,0,9009,9009,9009,9009,9009,9009,0,0,0,0,0
0,0,9012,9012,9012,9012,9012,9012,9012,9012,0,0,0,0,0,0,0,9005,9005,9005,9005,9005,9005,9005,9005,9005,9005,9005,9005,9005,9005,0,0,0,0,0,0,0,0,9008,9008,9008,9008,9008,9008,9008,9008,0,0,0,0,0,0,9009,9009,9009,9009,9009,9009,0,0,0,0,0
0,0,9012,9012,9012,9012,9012,9012,9012,9012,0,0,0,0,0,0,0,9005,9005,9005,9005,9005,9005,9005,9005,9005,9005,9005,9005,9005,9005,0,0,0,0,0,0,0,0,9008,9008,9008,9008,9008,9008,9008,9008,0,0,0,0,0,0,9009,9009,9009,9009,9009,9009,0,0,0,0,0
0,0,9012,9012,9012,9012,9012,9012,9012,9012,0,0,0,0,0,0,0,9005,9005,9005,9005,9005,9005,9005,9005,9005,9005,9005,9005,9005,9005,0,0,0,0,0,0,0,0,0,0,0,0,0,0,0,0,0,0,0,0,0,0,9009,9009,9009,9009,9009,9009,0,0,0,0,0
0,0,9012,9012,9012,9012,9012,9012,9012,9012,0,0,0,0,0,0,0,9005,9005,9005,9005,9005,9005,9005,9005,9005,9005,9005,9005,9005,9005,0,0,0,0,0,0,0,0,0,0,0,0,0,0,0,0,0,0,0,0,0,0,9009,9009,9009,9009,9009,9009,0,0,0,0,0
0,0,9012,9012,9012,9012,9012,9012,9012,9012,0,0,0,0,0,0,0,9005,9005,9005,9005,9005,9005,9005,9005,9005,9005,9005,9005,9005,9005,0,0,0,0,0,0,0,0,0,0,0,0,0,0,0,0,0,0,0,0,0,0,9009,9009,9009,9009,9009,9009,0,0,0,0,0
0,0,9012,9012,9012,9012,9012,9012,9012,9012,0,0,0,0,0,0,0,0,0,0,0,0,0,0,0,0,0,0,0,0,0,0,0,0,0,0,0,0,0,0,0,0,0,0,0,0,0,0,0,0,0,0,0,9009,9009,9009,9009,9009,9009,0,0,0,0,0
0,0,9012,9012,9012,9012,9012,9012,9012,9012,0,0,0,0,0,0,0,0,0,0,0,0,0,9002,9002,9002,0,0,0,0,0,0,0,0,0,0,0,0,0,0,0,0,0,0,0,0,0,0,0,0,0,0,0,9009,9009,9009,9009,9009,9009,0,0,0,0,0
0,0,9012,9012,9012,9012,9012,9012,9012,9012,0,0,0,0,0,0,0,0,0,0,0,0,0,9002,9002,9002,0,0,0,0,0,0,0,0,0,0,0,0,0,0,0,0,0,0,0,0,0,0,0,0,0,0,0,9009,9009,9009,9009,9009,9009,0,0,0,0,0
0,0,9012,9012,9012,9012,9012,9012,9012,9012,0,0,0,0,0,0,0,0,0,0,0,0,0,9002,9002,9002,0,0,0,0,0,0,0,0,0,0,0,0,0,0,0,0,0,0,0,0,0,0,0,0,0,0,0,9009,9009,9009,9009,9009,9009,0,0,0,0,0
0,0,0,0,0,0,0,0,0,0,0,0,0,0,0,0,0,0,0,0,0,0,0,9002,9002,9002,0,0,0,0,0,0,0,0,0,0,0,0,0,0,0,0,0,0,0,0,9010,9010,9010,9010,9010,9010,0,9009,9009,9009,9009,9009,9009,0,0,0,0,0
0,0,0,0,0,0,0,0,0,0,0,0,0,0,0,0,0,0,0,0,0,0,0,9002,9002,9002,0,0,0,0,0,0,0,0,0,0,0,0,0,0,0,0,0,0,0,0,9010,9010,9010,9010,9010,9010,0,9009,9009,9009,9009,9009,9009,0,0,0,0,0
0,0,0,0,0,0,0,0,0,0,0,0,0,0,0,0,0,0,0,0,0,0,0,9002,9002,9002,0,0,0,0,0,0,0,0,0,0,0,0,0,0,0,0,0,0,0,0,9010,9010,9010,9010,9010,9010,0,9009,9009,9009,9009,9009,9009,0,0,0,0,0
0,0,0,0,0,0,0,0,9003,9003,9003,9003,9003,9003,9003,0,0,0,0,0,0,0,0,9002,9002,9002,0,0,0,0,0,0,0,0,9004,9004,9004,9004,9004,9004,9004,0,0,0,0,0,9010,9010,9010,9010,9010,9010,0,9009,9009,9009,9009,9009,9009,0,0,0,0,0
0,0,0,0,0,0,0,0,9003,9003,9003,9003,9003,9003,9003,0,0,0,0,0,0,0,0,9002,9002,9002,0,0,0,0,0,0,0,0,9004,9004,9004,9004,9004,9004,9004,0,0,0,0,0,9010,9010,9010,9010,9010,9010,0,0,0,0,0,0,0,0,0,0,0,0
0,0,0,0,0,0,0,0,9003,9003,9003,9003,9003,9003,9003,0,9002,9002,9002,9002,9002,9002,9002,9002,9002,9002,9002,9002,9002,9002,9002,9002,9002,0,9004,9004,9004,9004,9004,9004,9004,0,0,0,0,0,9010,9010,9010,9010,9010,9010,9010,9010,9010,9010,9010,9010,9010,0,0,0,0,0
0,0,0,0,0,0,0,0,9003,9003,9003,9003,9003,9003,9003,0,9002,9002,9002,9002,9002,9002,9002,9002,9002,9002,9002,9002,9002,9002,9002,9002,9002,0,9004,9004,9004,9004,9004,9004,9004,0,0,0,0,0,9010,9010,9010,9010,9010,9010,9010,9010,9010,9010,9010,9010,9010,0,0,0,0,0
0,0,0,0,0,0,0,0,9003,9003,9003,9003,9003,9003,9003,0,9002,9002,9002,9002,9002,9002,9002,9002,9002,9002,9002,9002,9002,9002,9002,9002,9002,0,9004,9004,9004,9004,9004,9004,9004,0,0,0,0,0,9010,9010,9010,9010,9010,9010,9010,9010,9010,9010,9010,9010,9010,0,0,0,0,0
0,0,0,0,0,0,0,0,0,0,0,0,0,0,0,0,0,0,0,0,0,0,0,0,0,0,0,0,0,0,0,0,0,0,0,0,0,0,0,0,0,0,0,0,0,0,9010,9010,9010,9010,9010,9010,9010,9010,9010,9010,9010,9010,9010,0,0,0,0,0
0,0,0,0,0,0,0,0,0,0,0,0,0,0,0,0,0,0,0,0,0,0,9001,9001,9001,9001,9001,0,0,0,0,0,0,0,0,0,0,0,0,0,0,0,0,0,0,0,9010,9010,9010,9010,9010,9010,9010,9010,9010,9010,9010,9010,9010,0,0,0,0,0
0,0,0,0,0,0,0,0,0,0,0,0,0,0,0,0,0,0,0,0,0,0,9001,9001,9001,9001,9001,0,0,0,0,0,0,0,0,0,0,0,0,0,0,0,0,0,0,0,0,0,0,0,0,0,0,0,0,0,0,0,0,0,0,0,0,0
0,0,0,0,0,0,0,0,0,0,0,0,0,0,0,0,0,0,0,0,0,0,0,0,0,0,0,0,0,0,0,0,0,0,0,0,0,0,0,0,0,0,0,0,0,0,0,0,0,0,0,0,0,0,0,0,0,0,0,0,0,0,0,0
