64
1038
1041
0,0,0,0,0,0,0,0,0,0,0,0,0,0,0,0,0,0,0,0,0,0,0,0,0,0,0,0,0,0,0,0,0,0,0,0,0,0,0,0,0,0,0,0,0,0,0,0,0,0,0,0,0,0,0,0,0,0,0,0,0,0,0,0
0,1017,1017,1017,1017,1017,1017,1017,1017,1017,1017,1017,1017,1017,1017,1017,1017,1017,1017,1017,1017,1017,1017,1017,1017,1017,1017,1017,1017,1017,1017,1017,1017,1017,1017,1017,1017,1017,1017,1017,1017,1017,1017,1017,1017,1017,1017,1017,1017,1017,1017,1017,1017,1017,1017,1017,1017,1017,1017,1017,1017,1017,1017,0
0,1017,2036,0,0,0,0,2008,0,0,0,2034,1017,5011,2036,0,0,0,0,0,0,0,2008,0,0,0,0,0,0,0,0,0,0,0,0,0,0,0,0,0,0,0,0,0,0,0,0,0,0,2034,5003,1017,2036,0,0,0,0,2007,0,0,0,2034,1017,0
0,1017,0,0,0,0,0,0,0,0,0,0,3001,0,2006,0,0,0,0,0,0,5004,0,0,0,0,0,0,0,0,0,0,5004,0,0,0,0,0,0,0,0,0,0,0,5004,0,0,0,0,0,0,3001,5007,0,0,0,0,0,0,0,0,0,1017,0
0,1017,0,0,1016,1016,1016,1016,1016,1016,0,0,1017,0,0,0,0,0,0,0,0,0,0,0,0,0,0,0,0,0,0,0,0,0,0,0,0,0,0,0,0,0,0,0,0,0,0,0,0,2005,0,1017,0,0,1016,1016,1016,1016,1016,1016,0,0,1017,0
0,1017,0,0,1016,4007,0,0,4007,1016,0,0,1017,0,2033,0,0,0,0,0,0,0,0,0,0,0,0,0,0,0,0,0,0,0,0,0,0,2007,0,0,0,0,0,0,0,0,0,0,0,2035,5003,1017,2006,0,1016,4007,0,0,4007,1016,0,0,1017,0
0,1017,0,0,1016,0,0,0,0,1016,0,0,1017,1017,1017,1017,1017,1017,1017,1017,1017,1017,1017,1017,1029,1029,1029,1029,1029,1029,1029,1029,3002,1029,1029,1029,1029,1029,1029,1029,1029,1017,1017,1017,1017,1017,1017,1017,1017,1017,1017,1017,0,0,1016,0,4008,0,0,1016,0,0,1017,0
0,1017,2006,0,1016,0,5004,0,0,1016,0,2005,1017,0,0,0,0,0,0,0,0,0,0,0,1029,2036,0,0,0,0,0,0,0,0,0,0,0,0,0,2034,1029,0,0,0,0,0,0,0,0,0,0,1017,0,5007,1016,0,0,5004,0,1016,0,0,1017,0
0,1017,0,0,1016,4002,0,0,4002,1016,0,0,1017,0,0,0,0,0,0,0,0,0,0,0,1029,0,0,0,1029,1029,1029,0,0,0,1029,1029,1029,0,0,0,1029,0,0,0,0,0,0,0,0,0,0,1017,0,0,1016,4002,0,0,4002,1016,0,0,1017,0
0,1017,0,0,1016,1016,3002,1016,1016,1016,0,0,1017,0,0,0,0,0,0,0,0,0,0,0,1029,0,0,0,1029,1001,1029,0,0,0,1029,1001,1029,0,0,0,1029,0,0,0,0,0,0,0,0,0,0,1017,0,0,1016,1016,1016,3002,1016,1016,0,2005,1017,0
0,1017,0,0,0,0,0,0,0,0,0,0,1017,0,0,0,0,0,0,0,0,0,0,0,1029,0,0,0,1029,1001,1029,0,0,0,1029,1001,1029,0,0,0,1029,0,0,0,0,0,0,0,0,0,0,1017,0,5007,0,0,5007,5001,5007,0,0,0,1017,0
0,1017,2033,0,0,0,2007,0,0,0,0,2035,1017,0,0,0,0,0,0,0,0,0,0,0,1029,2006,0,0,1029,1001,1029,0,0,0,1029,1001,1029,0,0,2005,1029,0,0,0,0,0,0,0,0,0,0,1017,2033,0,0,0,2008,0,0,0,5007,2035,1017,0
0,1017,1017,3002,1017,1017,1017,1017,1017,1017,1017,1017,1017,0,0,0,0,0,0,0,0,0,0,0,1029,0,0,0,1029,1001,1029,0,5004,0,1029,1001,1029,0,0,0,1029,0,0,0,0,0,0,0,0,0,0,1017,1017,1017,1017,1017,1017,1017,1017,1017,3002,1017,1017,0
0,1017,0,0,0,0,1017,0,0,0,0,0,0,0,0,1029,1029,1029,1029,1029,1029,1029,1029,1029,1029,0,0,0,1029,1001,1029,0,0,0,1029,1001,1029,0,0,0,1029,1029,1029,1029,1029,1029,1029,1029,1029,0,0,0,0,0,0,0,0,1017,5003,0,0,5003,1017,0
0,1017,2036,0,2008,2034,1017,0,0,0,0,0,0,0,0,1029,2036,0,0,0,0,0,0,0,0,2034,0,0,1029,1001,1029,0,0,0,1029,1001,1029,0,0,2035,0,0,0,0,0,0,0,2034,1029,0,0,0,0,0,0,0,0,1017,2036,2008,0,2034,1017,0
0,1017,0,0,0,0,1017,0,0,0,0,0,0,0,0,1029,0,4007,1029,1029,1029,1029,0,0,0,0,0,0,1029,1029,1029,0,0,0,1029,1029,1029,0,0,0,0,0,1029,1029,1029,1029,4007,0,1029,0,0,0,0,0,0,0,0,1017,0,0,0,0,1017,0
0,1017,0,5004,0,0,1017,0,0,0,0,0,0,0,0,1029,0,0,1029,1001,1001,1029,0,2036,0,0,0,0,0,5003,0,0,0,0,0,5003,0,0,0,0,2034,0,1029,1001,1001,1029,0,0,1029,0,0,0,0,0,0,0,0,1017,0,0,0,0,1017,0
0,1017,0,0,0,0,1017,0,0,0,0,0,0,0,0,1029,0,0,1029,1001,1001,1029,0,2014,0,0,0,0,0,0,0,0,0,0,0,0,0,0,0,0,2013,0,1029,1001,1001,1029,0,0,1029,0,1030,1030,1030,1030,1030,1030,1030,1017,0,0,5004,0,1017,0
0,1017,2006,0,0,0,1017,0,0,0,0,0,0,0,0,1029,2006,5004,1029,1001,1001,1029,0,0,0,0,0,0,0,0,0,0,5008,0,0,0,0,0,0,0,0,0,1029,1001,1001,1029,5004,2005,1029,0,1030,4003,1030,2030,1030,4007,1030,1017,0,0,0,0,1017,0
0,1017,0,0,0,0,1017,0,0,0,0,0,0,0,0,1029,0,0,1029,1001,1001,1029,0,2033,0,0,0,5004,0,0,0,0,0,0,5008,0,0,5004,0,0,2035,0,1029,1001,1001,1029,0,0,1029,0,1030,0,1030,0,1030,0,1030,1017,0,0,0,0,1017,0
0,1017,0,0,0,0,1017,0,0,0,0,0,0,0,0,1029,0,0,1029,1001,1001,1029,5006,0,0,0,0,0,0,0,5008,0,0,0,0,0,0,0,0,0,0,5006,1029,1001,1001,1029,0,0,1029,0,1030,0,1030,0,1030,0,1030,1017,0,0,0,0,1017,0
0,1017,0,0,0,0,1017,0,0,0,0,0,0,0,0,1029,0,4002,1029,1029,1029,1029,0,0,0,0,0,0,5008,0,0,0,0,0,0,0,0,5008,0,0,0,0,1029,1029,1029,1029,4002,0,1029,0,1030,3002,1030,3002,1030,3002,1030,1017,0,0,0,0,1017,0
0,1017,0,0,0,0,1017,0,0,0,0,0,0,0,0,1029,2033,0,0,0,0,0,0,0,0,0,0,0,0,0,5005,0,5005,0,5005,0,0,0,0,0,0,0,0,0,0,0,0,2035,1029,0,1030,0,0,0,0,0,1030,1017,0,0,0,0,1017,0
0,1017,0,0,0,0,1017,0,0,0,0,0,0,0,0,1029,1029,1029,1029,1029,1029,1029,1029,1029,1029,1029,3002,1029,1029,1029,1029,1029,1029,1029,1029,1029,1029,1029,3002,1029,1029,1029,1029,1029,1029,1029,1029,1029,1029,0,1030,0,2036,0,2034,0,1030,1017,0,0,0,0,1017,0
0,1017,0,0,0,0,1017,0,0,0,0,0,0,0,0,0,0,0,0,0,0,0,1030,1030,1030,0,0,0,1030,1030,1030,0,2042,0,1030,1030,1030,0,0,0,1030,1030,0,0,0,0,0,0,0,0,1030,0,0,0,0,0,1030,1017,0,0,0,0,1017,0
0,1017,0,0,0,0,1017,0,0,0,0,0,0,0,0,0,0,0,0,0,0,0,1030,5006,0,0,0,0,0,5006,1030,0,0,0,1030,5006,0,0,0,0,5006,1030,0,0,0,0,0,0,0,0,1030,5008,0,5004,0,0,1030,1017,0,0,0,0,1017,0
0,1017,0,0,0,0,1017,0,0,0,0,0,0,0,0,0,0,0,0,0,0,0,1030,0,0,0,2017,0,0,0,3003,0,0,0,3005,0,0,0,2017,0,0,1030,0,0,0,0,0,0,0,0,1030,0,0,0,0,5005,1030,1017,0,0,0,0,1017,0
0,1017,0,0,0,0,1017,0,0,0,0,0,0,0,0,0,0,0,0,0,0,0,1030,0,0,0,5004,0,0,0,1030,1012,3002,1012,1030,0,0,0,5004,0,0,1030,0,0,0,0,0,0,0,0,1030,0,2006,0,0,0,1030,1017,0,0,0,0,1017,0
0,1017,0,0,0,0,1017,0,0,0,0,0,0,0,0,0,0,0,0,0,0,0,1030,0,0,0,0,0,0,4001,1030,1012,4011,1012,1030,4001,0,0,0,0,0,1030,0,0,0,0,0,0,0,0,1030,0,0,0,0,0,1030,1017,0,0,5004,0,1017,0
0,1017,0,0,0,0,1017,0,0,0,0,1030,1030,1030,1030,1030,1030,1030,1030,1030,1030,1030,1030,1030,3002,1030,1030,1030,1030,1030,1030,1012,1012,1012,1030,1030,1030,1030,1030,3006,1030,1030,1030,1030,1030,1030,1030,1030,1030,1030,1030,5008,0,5008,0,5005,1030,1017,0,0,0,0,1017,0
0,1017,0,0,0,0,1017,0,0,0,0,1030,4002,0,0,0,0,1030,5014,0,0,0,0,0,0,0,5014,1030,0,0,0,0,0,0,0,0,1030,5014,0,0,0,0,5014,1030,0,0,0,0,0,0,0,0,0,0,0,0,1030,1017,0,0,0,0,1017,0
0,1017,0,5004,0,0,1017,0,0,0,0,1030,0,0,0,0,0,3001,0,0,0,0,0,0,0,0,0,1030,0,0,0,0,0,0,0,0,1030,0,0,0,0,0,0,1030,0,2036,0,0,5008,0,0,0,2034,0,2005,0,1030,1017,0,0,0,0,1017,0
0,1017,0,0,0,0,1017,0,0,0,0,1030,5008,0,5004,0,0,1030,0,0,0,0,5004,0,0,0,0,1030,0,0,0,0,0,0,0,0,1030,0,0,5004,0,0,0,3001,0,2033,0,0,0,2007,0,0,0,5004,2035,0,1030,1017,0,0,0,0,1017,0
0,1017,0,0,0,0,1017,0,0,0,0,1030,0,0,0,5008,0,1030,5014,0,0,0,0,0,0,0,5014,1030,0,0,0,0,0,0,0,0,1030,5014,0,0,0,0,5014,1030,0,0,0,5008,0,0,0,5008,0,0,5008,0,1030,1017,0,0,0,0,1017,0
0,1017,0,0,0,0,1017,0,0,0,0,1030,5005,0,0,0,0,1030,1030,1030,1030,1030,1030,1030,3002,1030,1030,1030,1030,1030,1030,1030,1030,1030,1030,1030,1030,1030,1030,3002,1030,1030,1030,1030,1030,1030,1030,1030,1030,1030,1030,1030,1030,1030,1030,1030,1030,1017,2006,0,0,2005,1017,0
0,1017,0,0,0,0,1017,0,0,0,0,1030,0,5008,0,5008,0,1030,0,1030,5014,0,0,0,0,0,0,0,0,0,5014,1030,5014,0,0,0,0,0,0,0,0,0,5014,1030,0,0,0,0,0,0,0,0,0,0,0,0,0,1017,0,0,0,0,1017,0
0,1017,0,0,0,0,1017,0,0,0,0,1030,0,0,0,0,0,1030,0,1030,0,2036,0,0,0,0,0,0,0,2034,0,1030,0,2036,0,0,0,0,0,0,0,2034,0,1030,0,0,0,0,0,0,0,0,0,0,0,0,0,1017,0,0,0,0,1017,0
0,1017,0,0,0,2005,1017,0,0,0,0,1030,5005,0,5004,0,0,1030,0,1030,0,2014,0,0,5004,0,0,0,0,2013,0,1030,0,2014,0,0,0,0,0,5004,0,2013,0,1030,0,0,0,0,0,0,0,0,0,0,0,0,0,1017,0,0,0,0,1017,0
0,1017,0,0,0,0,1017,0,0,0,0,1030,0,0,2017,0,0,1030,0,1030,0,2033,0,0,0,0,0,0,0,2035,0,1030,0,2033,0,0,0,0,0,0,0,2035,0,1030,0,0,0,0,0,0,0,0,0,0,0,0,0,1017,0,0,0,0,1017,0
0,1017,0,0,0,0,1017,0,0,0,0,1030,0,5008,0,5008,0,1030,0,1030,4003,0,0,0,0,0,0,0,0,0,4007,1030,4007,0,0,0,0,0,0,0,0,0,4003,1030,0,0,0,0,0,0,0,0,0,0,0,0,0,1017,0,0,0,0,1017,0
0,1017,0,0,0,0,1017,0,0,0,0,1030,0,0,0,0,0,1030,0,1030,1030,1030,1030,3002,1030,1030,1030,1030,1030,1030,1030,1030,1030,1030,1030,1030,1030,1030,1030,3002,1030,1030,1030,1030,0,0,0,0,0,0,0,0,0,0,0,0,0,1017,0,0,0,0,1017,0
0,1017,0,0,0,0,1017,0,0,0,0,1030,3002,1030,3002,1030,3002,1030,0,1028,1028,1028,0,0,0,1028,1028,1028,1028,1028,1028,1028,1028,1028,1028,1028,1028,1028,0,0,0,1028,1028,1028,0,1001,0,0,0,1001,1001,1001,1001,0,1001,0,0,1017,0,0,5004,0,1017,0
0,1017,0,0,0,0,1017,0,0,0,0,1030,0,1030,0,1030,0,1030,0,1028,4003,0,0,0,0,0,4007,1028,0,0,0,2042,0,0,0,1028,5014,2002,0,5004,0,2002,5014,1028,0,1001,0,0,0,1001,0,0,1001,0,1001,0,0,1017,0,0,0,0,1017,0
0,1017,0,0,0,0,1017,0,0,0,0,1030,0,1030,0,1030,0,1030,0,1028,0,0,0,0,0,0,0,1028,0,0,4003,0,4003,0,0,1028,0,0,2002,0,2002,0,0,1028,0,1001,0,0,0,1001,0,0,1001,0,1001,0,0,1017,0,0,0,0,1017,0
0,1017,0,0,0,0,1017,0,0,0,0,1030,0,1030,0,1030,0,1030,0,1028,0,0,0,5004,0,0,0,1028,1028,1028,1028,3002,1028,1028,1028,1028,0,0,0,2010,0,0,0,1028,0,1001,0,0,0,1001,0,0,1001,0,1001,0,0,1017,0,0,0,0,1017,0
0,1017,0,5004,0,0,1017,0,0,0,0,1030,4003,1030,2025,1030,4007,1030,0,1028,0,0,0,0,0,0,0,1028,0,0,0,0,0,0,0,1028,0,0,0,0,0,0,0,1028,0,1001,0,0,0,1001,0,0,1001,0,1001,0,0,1017,0,0,0,0,1017,0
0,1017,0,0,0,0,1017,0,0,0,0,1030,1030,1030,1030,1030,1030,1030,0,1028,0,0,0,0,0,0,0,1028,0,4007,0,0,0,4007,0,1028,0,0,0,0,0,0,0,1028,0,1001,0,0,0,1001,0,0,1001,0,1001,0,0,1017,0,0,0,0,1017,0
0,1017,0,0,0,0,1017,0,0,0,0,0,0,0,0,0,0,0,0,1028,0,0,0,0,0,0,0,1028,0,0,0,0,0,0,0,1028,0,0,0,0,0,0,0,1028,0,1001,0,0,0,1001,0,0,1001,0,1001,0,0,1017,0,0,0,0,1017,0
0,1017,0,0,0,0,1017,0,0,0,0,0,0,0,0,0,0,0,0,1028,0,0,0,0,0,0,0,1028,0,0,0,5004,0,0,0,1028,0,0,0,0,0,0,0,1028,0,1001,1001,1001,0,1001,1001,1001,1001,0,1001,1001,1001,1017,0,0,0,0,1017,0
0,1017,2033,2007,0,2035,1017,0,0,0,0,0,0,0,0,0,0,0,0,1028,0,0,0,2009,0,0,0,1028,0,0,0,0,0,0,0,1028,0,0,0,0,0,0,0,1028,0,0,0,0,0,0,0,0,0,0,0,0,0,1017,2033,0,2007,2035,1017,0
0,1017,0,0,0,0,1017,0,0,0,0,0,0,0,0,0,0,0,0,1028,0,0,2001,0,2001,0,0,1028,0,0,0,0,0,0,0,1028,0,0,0,5004,0,0,0,1028,0,0,0,0,0,0,0,0,0,0,0,0,0,1017,0,0,0,0,1017,0
0,1017,1017,3002,1017,1017,1017,1017,1017,1017,1017,1017,1017,0,0,0,0,0,0,1028,0,2001,0,5004,0,2001,0,1028,0,0,0,0,0,0,0,1028,0,0,0,0,0,0,0,1028,0,0,0,0,0,0,0,1017,1017,1017,1017,1017,1017,1017,1017,1017,3002,1017,1017,0
0,1017,2036,0,0,0,2007,0,0,0,0,2034,1017,0,0,0,0,0,0,1028,5014,0,0,0,0,0,5014,1028,0,0,0,0,0,0,0,1028,4003,0,0,0,0,0,4007,1028,0,0,0,0,0,0,0,1017,2036,0,0,0,0,0,2007,0,0,2034,1017,0
0,1017,0,0,0,0,0,0,0,0,0,0,1017,0,0,0,0,0,0,1028,1028,1028,1028,3002,1028,1028,1028,1028,1028,1028,0,0,0,0,0,1028,1028,1028,1028,3002,1028,1028,1028,1028,1028,1028,0,0,0,0,0,1017,0,0,0,0,0,0,0,0,0,0,1017,0
0,1017,0,0,1016,1016,3002,1016,1016,1016,0,0,1017,0,0,0,0,0,0,1028,0,0,0,0,0,0,0,0,0,1028,0,0,0,0,0,1028,0,0,0,0,0,0,0,0,4002,1028,0,0,0,0,0,1017,2006,0,1016,1016,1016,3002,1016,1016,0,0,1017,0
0,1017,0,0,1016,4007,0,0,4007,1016,0,0,1017,0,0,0,0,0,0,1028,0,0,0,0,0,0,0,0,0,3001,0,0,5004,0,0,3001,0,0,0,0,0,0,0,4009,0,1028,0,0,0,0,0,1017,0,0,1016,4002,0,0,4002,1016,0,0,1017,0
0,1017,2006,0,1016,0,5004,0,0,1016,0,0,1017,0,0,0,0,0,0,1028,1028,1028,1028,1028,1028,1028,1028,1028,1028,1028,0,0,0,0,0,1028,1028,1028,1028,1028,1028,1028,1028,1028,1028,1028,0,0,0,0,0,1017,0,0,1016,0,0,5004,0,1016,0,0,1017,0
0,1017,0,0,1016,0,0,0,0,1016,0,2005,1017,1017,1017,1017,1017,1017,1017,1017,1017,1017,1017,1017,1017,1017,1017,1017,1017,1017,1017,1017,1017,1017,1017,1017,1017,1017,1017,1017,1017,1017,1017,1017,1017,1017,1017,1017,1017,1017,1017,1017,0,0,1016,0,0,0,0,1016,0,0,1017,0
0,1017,0,0,1016,4002,4010,0,4002,1016,0,0,1017,5011,2036,0,0,0,0,0,0,0,0,0,0,0,0,0,0,0,2008,0,0,0,0,0,0,0,0,0,0,0,0,0,0,0,0,0,0,2034,0,1017,0,0,1016,4007,0,0,4007,1016,0,0,1017,0
0,1017,0,0,1016,1016,1016,1016,1016,1016,0,0,1017,0,2006,0,0,0,0,0,0,0,0,0,0,0,0,0,0,0,0,0,0,0,0,0,0,0,0,0,0,0,0,0,0,0,0,0,0,0,0,1017,0,0,1016,1016,1016,1016,1016,1016,0,2005,1017,0
0,1017,0,0,0,0,0,0,0,0,0,0,3001,0,0,0,0,5004,0,0,0,0,0,0,0,0,0,0,0,0,5004,0,0,0,0,0,0,0,0,0,0,0,0,0,0,5004,0,0,0,2005,0,3001,0,0,0,0,0,0,0,0,0,0,1017,0
0,1017,2033,0,0,0,2008,0,0,0,0,2035,1017,0,2033,0,0,0,0,0,0,0,0,0,0,0,0,0,0,0,2007,0,0,0,0,0,0,0,0,0,0,0,0,0,0,0,0,0,0,2035,0,1017,2033,0,0,2008,0,0,0,0,0,2035,1017,0
0,1017,1017,1017,1017,1017,1017,1017,1017,1017,1017,1017,1017,1017,1017,1017,1017,1017,1017,1017,1017,1017,1017,1017,1017,1017,1017,1017,1017,1017,1017,1017,1017,1017,1017,1017,1017,1017,1017,1017,1017,1017,1017,1017,1017,1017,1017,1017,1017,1017,1017,1017,1017,1017,1017,1017,1017,1017,1017,1017,1017,1017,1017,0
0,0,0,0,0,0,0,0,0,0,0,0,0,0,0,0,0,0,0,0,0,0,0,0,0,0,0,0,0,0,0,0,0,0,0,0,0,0,0,0,0,0,0,0,0,0,0,0,0,0,0,0,0,0,0,0,0,0,0,0,0,0,1017,0

0,0,0,0,0,0,0,0,0,0,0,0,0,0,0,0,0,0,0,0,0,0,0,0,0,0,0,0,0,0,0,0,0,0,0,0,0,0,0,0,0,0,0,0,0,0,0,0,0,0,0,0,0,0,0,0,0,0,0,0,0,0,0,0
0,0,0,0,0,0,0,0,0,0,0,0,0,0,0,0,0,0,0,0,0,0,0,0,0,0,0,0,0,0,0,0,0,0,0,0,0,0,0,0,0,0,0,0,0,0,0,0,0,0,0,0,0,0,0,0,0,0,0,0,0,0,0,0
0,0,9029,9029,9029,9029,9029,9029,9029,9029,9029,9029,0,9028,9028,9028,9028,9028,9028,9028,9028,9028,9028,9028,9028,9028,9028,9028,9028,9028,9028,9028,9028,9028,9028,9028,9028,9028,9028,9028,9028,9028,9028,9028,9028,9028,9028,9028,9028,9028,9028,0,9027,9027,9027,9027,9027,9027,9027,9027,9027,9027,0,0
0,0,9029,9029,9029,9029,9029,9029,9029,9029,9029,9029,0,9028,9028,9028,9028,9028,9028,9028,9028,9028,9028,9028,9028,9028,9028,9028,9028,9028,9028,9028,9028,9028,9028,9028,9028,9028,9028,9028,9028,9028,9028,9028,9028,9028,9028,9028,9028,9028,9028,0,9027,9027,9027,9027,9027,9027,9027,9027,9027,9027,0,0
0,0,9029,9029,0,0,0,0,0,0,9029,9029,0,9028,9028,9028,9028,9028,9028,9028,9028,9028,9028,9028,9028,9028,9028,9028,9028,9028,9028,9028,9028,9028,9028,9028,9028,9028,9028,9028,9028,9028,9028,9028,9028,9028,9028,9028,9028,9028,9028,0,9027,9027,0,0,0,0,0,0,9027,9027,0,0
0,0,9029,9029,0,9003,9003,9003,9003,0,9029,9029,0,9028,9028,9028,9028,9028,9028,9028,9028,9028,9028,9028,9028,9028,9028,9028,9028,9028,9028,9028,9028,9028,9028,9028,9028,9028,9028,9028,9028,9028,9028,9028,9028,9028,9028,9028,9028,9028,9028,0,9027,9027,0,9004,9004,9004,9004,0,9027,9027,0,0
0,0,9029,9029,0,9003,9003,9003,9003,0,9029,9029,0,0,0,0,0,0,0,0,0,0,0,0,0,0,0,0,0,0,0,0,0,0,0,0,0,0,0,0,0,0,0,0,0,0,0,0,0,0,0,0,9027,9027,0,9004,9004,9004,9004,0,9027,9027,0,0
0,0,9029,9029,0,9003,9003,9003,9003,0,9029,9029,0,0,0,0,0,0,0,0,0,0,0,0,0,9006,9006,9006,9006,9006,9006,9006,9006,9006,9006,9006,9006,9006,9006,9006,0,0,0,0,0,0,0,0,0,0,0,0,9027,9027,0,9004,9004,9004,9004,0,9027,9027,0,0
0,0,9029,9029,0,9003,9003,9003,9003,0,9029,9029,0,0,0,0,0,0,0,0,0,0,0,0,0,9006,9006,9006,0,0,0,9006,9006,9006,0,0,0,9006,9006,9006,0,0,0,0,0,0,0,0,0,0,0,0,9027,9027,0,9004,9004,9004,9004,0,9027,9027,0,0
0,0,9029,9029,0,0,0,0,0,0,9029,9029,0,0,0,0,0,0,0,0,0,0,0,0,0,9006,9006,9006,0,0,0,9006,9006,9006,0,0,0,9006,9006,9006,0,0,0,0,0,0,0,0,0,0,0,0,9027,9027,0,0,0,0,0,0,9027,9027,0,0
0,0,9029,9029,9029,9029,9029,9029,9029,9029,9029,9029,0,0,0,0,0,0,0,0,0,0,0,0,0,9006,9006,9006,0,0,0,9006,9006,9006,0,0,0,9006,9006,9006,0,0,0,0,0,0,0,0,0,0,0,0,9027,9027,9027,9027,9027,9027,9027,9027,9027,9027,0,0
0,0,9029,9029,9029,9029,9029,9029,9029,9029,9029,9029,0,0,0,0,0,0,0,0,0,0,0,0,0,9006,9006,9006,0,0,0,9006,9006,9006,0,0,0,9006,9006,9006,0,0,0,0,0,0,0,0,0,0,0,0,9027,9027,9027,9027,9027,9027,9027,9027,9027,9027,0,0
0,0,0,0,0,0,0,0,0,0,0,0,0,0,0,0,0,0,0,0,0,0,0,0,0,9006,9006,9006,0,0,0,9006,9006,9006,0,0,0,9006,9006,9006,0,0,0,0,0,0,0,0,0,0,0,0,0,0,0,0,0,0,0,0,0,0,0,0
0,0,9030,9030,9030,9030,0,0,0,0,0,0,0,0,0,0,0,0,0,0,0,0,0,0,0,9006,9006,9006,0,0,0,9006,9006,9006,0,0,0,9006,9006,9006,0,0,0,0,0,0,0,0,0,0,0,0,0,0,0,0,0,0,9026,9026,9026,9026,0,0
0,0,9030,9030,9030,9030,0,0,0,0,0,0,0,0,0,0,9006,9006,9006,9006,9006,9006,9006,9006,9006,9006,9006,9006,0,0,0,9006,9006,9006,0,0,0,9006,9006,9006,9006,9006,9006,9006,9006,9006,9006,9006,0,0,0,0,0,0,0,0,0,0,9026,9026,9026,9026,0,0
0,0,9030,9030,9030,9030,0,0,0,0,0,0,0,0,0,0,9006,9006,0,0,0,0,9006,9006,9006,9006,9006,9006,0,0,0,9006,9006,9006,0,0,0,9006,9006,9006,9006,9006,0,0,0,0,9006,9006,0,0,0,0,0,0,0,0,0,0,9026,9026,9026,9026,0,0
0,0,9030,9030,9030,9030,0,0,0,0,0,0,0,0,0,0,9006,9006,0,0,0,0,9006,9006,9006,9006,9006,9006,9006,9006,9006,9006,9006,9006,9006,9006,9006,9006,9006,9006,9006,9006,0,0,0,0,9006,9006,0,0,0,0,0,0,0,0,0,0,9026,9026,9026,9026,0,0
0,0,9030,9030,9030,9030,0,0,0,0,0,0,0,0,0,0,9006,9006,0,0,0,0,9006,9006,0,9006,9006,9006,9006,9006,9006,9006,9006,9006,9006,9006,9006,9006,9006,0,9006,9006,0,0,0,0,9006,9006,0,0,0,0,0,0,0,0,0,0,9026,9026,9026,9026,0,0
0,0,9030,9030,9030,9030,0,0,0,0,0,0,0,0,0,0,9006,9006,0,0,0,0,9006,9006,0,0,0,0,0,0,0,0,0,0,0,0,0,0,0,0,9006,9006,0,0,0,0,9006,9006,0,0,0,9024,0,9024,0,9024,0,0,9026,9026,9026,9026,0,0
0,0,9030,9030,9030,9030,0,0,0,0,0,0,0,0,0,0,9006,9006,0,0,0,0,9006,9006,9006,9006,9006,9006,9006,9006,9006,9006,9006,9006,9006,9006,9006,9006,9006,9006,9006,9006,0,0,0,0,9006,9006,0,0,0,9024,0,9024,0,9024,0,0,9026,9026,9026,9026,0,0
0,0,9030,9030,9030,9030,0,0,0,0,0,0,0,0,0,0,9006,9006,0,0,0,0,9006,9006,9006,9006,9006,9006,9006,9006,9006,9006,9006,9006,9006,9006,9006,9006,9006,9006,9006,9006,0,0,0,0,9006,9006,0,0,0,9024,0,9024,0,9024,0,0,9026,9026,9026,9026,0,0
0,0,9030,9030,9030,9030,0,0,0,0,0,0,0,0,0,0,9006,9006,0,0,0,0,9006,9006,9006,9006,9006,9006,9006,9006,9006,9006,9006,9006,9006,9006,9006,9006,9006,9006,9006,9006,0,0,0,0,9006,9006,0,0,0,0,0,0,0,0,0,0,9026,9026,9026,9026,0,0
0,0,9030,9030,9030,9030,0,0,0,0,0,0,0,0,0,0,9006,9006,9006,9006,9006,9006,9006,9006,9006,9006,9006,9006,9006,9006,9006,9006,9006,9006,9006,9006,9006,9006,9006,9006,9006,9006,9006,9006,9006,9006,9006,9006,0,0,0,9020,9020,9020,9020,9020,0,0,9026,9026,9026,9026,0,0
0,0,9030,9030,9030,9030,0,0,0,0,0,0,0,0,0,0,0,0,0,0,0,0,0,0,0,0,0,0,0,0,0,0,0,0,0,0,0,0,0,0,0,0,0,0,0,0,0,0,0,0,0,9020,9020,9020,9020,9020,0,0,9026,9026,9026,9026,0,0
0,0,9030,9030,9030,9030,0,0,0,0,0,0,0,0,0,0,0,0,0,0,0,0,0,9007,9007,9007,9007,9007,9007,9007,0,9023,9023,9023,0,9022,9022,9022,9022,9022,9022,0,0,0,0,0,0,0,0,0,0,9020,9020,9020,9020,9020,0,0,9026,9026,9026,9026,0,0
0,0,9030,9030,9030,9030,0,0,0,0,0,0,0,0,0,0,0,0,0,0,0,0,0,9007,9007,9007,9007,9007,9007,9007,0,9023,9023,9023,0,9022,9022,9022,9022,9022,9022,0,0,0,0,0,0,0,0,0,0,9020,9020,9020,9020,9020,0,0,9026,9026,9026,9026,0,0
0,0,9030,9030,9030,9030,0,0,0,0,0,0,0,0,0,0,0,0,0,0,0,0,0,9007,9007,9007,9007,9007,9007,9007,0,9023,9023,9023,0,9022,9022,9022,9022,9022,9022,0,0,0,0,0,0,0,0,0,0,9020,9020,9020,9020,9020,0,0,9026,9026,9026,9026,0,0
0,0,9030,9030,9030,9030,0,0,0,0,0,0,0,0,0,0,0,0,0,0,0,0,0,9007,9007,9007,9007,9007,9007,9007,0,0,0,0,0,9022,9022,9022,9022,9022,9022,0,0,0,0,0,0,0,0,0,0,9020,9020,9020,9020,9020,0,0,9026,9026,9026,9026,0,0
0,0,9030,9030,9030,9030,0,0,0,0,0,0,0,0,0,0,0,0,0,0,0,0,0,9007,9007,9007,9007,9007,9007,9007,0,0,0,0,0,9022,9022,9022,9022,9022,9022,0,0,0,0,0,0,0,0,0,0,9020,9020,9020,9020,9020,0,0,9026,9026,9026,9026,9017,0
0,0,9030,9030,9030,9030,0,0,0,0,0,0,0,0,0,0,0,0,0,0,0,0,0,0,0,0,0,0,0,0,0,0,0,0,0,0,0,0,0,0,0,0,0,0,0,0,0,0,0,0,0,9020,9020,9020,9020,9020,0,0,9026,9026,9026,9026,0,0
0,0,9030,9030,9030,9030,0,0,0,0,0,0,9009,9009,9009,9009,9009,0,9008,9008,9008,9008,9008,9008,9008,9008,9008,0,9021,9021,9021,9021,9021,9021,9021,9021,0,9019,9019,9019,9019,9019,9019,0,9020,9020,9020,9020,9020,9020,9020,9020,9020,9020,9020,9020,0,0,9026,9026,9026,9026,0,0
0,0,9030,9030,9030,9030,0,0,0,0,0,0,9009,9009,9009,9009,9009,0,9008,9008,9008,9008,9008,9008,9008,9008,9008,0,9021,9021,9021,9021,9021,9021,9021,9021,0,9019,9019,9019,9019,9019,9019,0,9020,9020,9020,9020,9020,9020,9020,9020,9020,9020,9020,9020,0,0,9026,9026,9026,9026,0,0
0,0,9030,9030,9030,9030,0,0,0,0,0,0,9009,9009,9009,9009,9009,0,9008,9008,9008,9008,9008,9008,9008,9008,9008,0,9021,9021,9021,9021,9021,9021,9021,9021,0,9019,9019,9019,9019,9019,9019,0,9020,9020,9020,9020,9020,9020,9020,9020,9020,9020,9020,9020,0,0,9026,9026,9026,9026,0,0
0,0,9030,9030,9030,9030,0,0,0,0,0,0,9009,9009,9009,9009,9009,0,9008,9008,9008,9008,9008,9008,9008,9008,9008,0,9021,9021,9021,9021,9021,9021,9021,9021,0,9019,9019,9019,9019,9019,9019,0,9020,9020,9020,9020,9020,9020,9020,9020,9020,9020,9020,9020,0,0,9026,9026,9026,9026,0,0
0,0,9030,9030,9030,9030,0,0,0,0,0,0,9009,9009,9009,9009,9009,0,0,0,0,0,0,0,0,0,0,0,0,0,0,0,0,0,0,0,0,0,0,0,0,0,0,0,0,0,0,0,0,0,0,0,0,0,0,0,0,0,9026,9026,9026,9026,0,0
0,0,9030,9030,9030,9030,0,0,0,0,0,0,9009,9009,9009,9009,9009,0,0,0,9011,9011,9011,9011,9011,9011,9011,9011,9011,9011,9011,0,9018,9018,9018,9018,9018,9018,9018,9018,9018,9018,0,0,0,0,0,0,0,0,0,0,0,0,0,0,0,0,9026,9026,9026,9026,0,0
0,0,9030,9030,9030,9030,0,0,0,0,0,0,9009,9009,9009,9009,9009,0,0,0,9011,9011,9011,9011,9011,9011,9011,9011,9011,9011,9011,0,9018,9018,9018,9018,9018,9018,9018,9018,9018,9018,9018,9018,0,0,0,0,0,0,0,0,0,0,0,0,0,0,9026,9026,9026,9026,0,0
0,0,9030,9030,9030,9030,0,0,0,0,0,0,9009,9009,9009,9009,9009,0,0,0,9011,9011,9011,9011,9011,9011,9011,9011,9011,9011,9011,0,9018,9018,9018,9018,9018,9018,9018,9018,9018,9018,9018,0,0,0,0,0,0,0,0,0,0,0,0,0,0,0,9026,9026,9026,9026,0,0
0,0,9030,9030,9030,9030,0,0,0,0,0,0,9009,9009,9009,9009,9009,0,0,0,9011,9011,9011,9011,9011,9011,9011,9011,9011,9011,9011,0,9018,9018,9018,9018,9018,9018,9018,9018,9018,9018,9018,9017,0,0,0,0,0,0,0,0,0,0,0,0,0,0,9026,9026,9026,9026,0,0
0,0,9030,9030,9030,9030,0,0,0,0,0,0,9009,9009,9009,9009,9009,0,0,0,9011,9011,9011,9011,9011,9011,9011,9011,9011,9011,9011,0,9018,9018,9018,9018,9018,9018,9018,9018,9018,9018,9018,0,0,0,0,0,0,0,0,0,0,0,0,0,0,0,9026,9026,9026,9026,0,0
0,0,9030,9030,9030,9030,0,0,0,0,0,0,9009,9009,9009,9009,9009,0,0,0,0,0,0,0,0,0,0,0,0,0,0,0,0,0,0,0,0,0,0,0,0,9017,0,0,0,0,0,0,0,0,0,0,0,0,0,0,0,0,9026,9026,9026,9026,0,0
0,0,9030,9030,9030,9030,0,0,0,0,0,0,0,0,0,0,0,0,0,0,0,0,9012,9012,9012,0,0,0,0,0,0,0,0,0,0,0,0,0,9017,9017,9017,0,0,0,0,0,0,0,0,0,0,0,0,0,0,0,0,0,9026,9026,9026,9026,0,0
0,0,9030,9030,9030,9030,0,0,0,0,0,0,9010,0,9010,0,9010,0,0,0,9012,9012,9012,9012,9012,9012,9012,0,9015,9015,9015,9015,9015,9015,9015,0,9017,9017,9017,9017,9017,9017,9017,0,0,0,0,0,0,0,0,0,0,0,0,0,0,0,9026,9026,9026,9026,0,0
0,0,9030,9030,9030,9030,0,0,0,0,0,0,9010,0,9010,0,9010,0,0,0,9012,9012,9012,9012,9012,9012,9012,0,9015,9015,9015,9015,9015,9015,9015,0,9017,9017,9017,9017,9017,9017,9017,0,0,0,0,0,0,0,0,0,0,0,0,0,0,0,9026,9026,9026,9026,0,0
0,0,9030,9030,9030,9030,0,0,0,0,0,0,9010,0,9010,0,9010,0,0,0,9012,9012,9012,9012,9012,9012,9012,0,0,0,0,0,0,0,0,0,9017,9017,9017,9017,9017,9017,9017,0,0,0,0,0,0,0,0,0,0,0,0,0,0,0,9026,9026,9026,9026,0,0
0,0,9030,9030,9030,9030,0,0,0,0,0,0,9010,0,9010,0,9010,0,0,0,9012,9012,9012,9012,9012,9012,9012,0,9014,9014,9014,9014,9014,9014,9014,0,9017,9017,9017,9017,9017,9017,9017,0,0,0,0,0,0,0,0,0,0,0,0,0,0,0,9026,9026,9026,9026,0,0
0,0,9030,9030,9030,9030,0,0,0,0,0,0,0,0,0,0,0,0,0,0,9012,9012,9012,9012,9012,9012,9012,0,9014,9014,9014,9014,9014,9014,9014,0,9017,9017,9017,9017,9017,9017,9017,0,0,0,0,0,0,0,0,0,0,0,0,0,0,0,9026,9026,9026,9026,0,0
0,0,9030,9030,9030,9030,0,0,0,0,0,0,0,0,0,0,0,0,0,0,9012,9012,9012,9012,9012,9012,9012,0,9014,9014,9014,9014,9014,9014,9014,0,9017,9017,9017,9017,9017,9017,9017,0,0,0,0,0,0,0,0,0,0,0,0,0,0,0,9026,9026,9026,9026,0,0
0,0,9030,9030,9030,9030,0,0,0,0,0,0,0,0,0,0,0,0,0,0,9012,9012,9012,9012,9012,9012,9012,0,9014,9014,9014,9014,9014,9014,9014,0,9017,9017,9017,9017,9017,9017,9017,0,0,0,0,0,0,0,0,0,0,0,0,0,0,0,9026,9026,9026,9026,0,0
0,0,9030,9030,9030,9030,0,0,0,0,0,0,0,0,0,0,0,0,0,0,9012,9012,9012,9012,9012,9012,9012,0,9014,9014,9014,9014,9014,9014,9014,0,9017,9017,9017,9017,9017,9017,9017,0,0,0,0,0,0,0,0,0,0,0,0,0,0,0,9026,9026,9026,9026,0,0
0,0,9030,9030,9030,9030,0,0,0,0,0,0,0,0,0,0,0,0,0,0,9012,9012,9012,9012,9012,9012,9012,0,9014,9014,9014,9014,9014,9014,9014,0,9017,9017,9017,9017,9017,9017,9017,0,0,0,0,0,0,0,0,0,0,0,0,0,0,0,9026,9026,9026,9026,0,0
0,0,9030,0,0,0,0,0,0,0,0,0,0,0,0,0,0,0,0,0,9012,9012,9012,9012,9012,9012,9012,0,9014,9014,9014,9014,9014,9014,9014,0,9017,9017,9017,9017,9017,9017,9017,0,0,0,0,0,0,0,0,0,0,0,0,0,0,0,0,0,0,0,0,0
0,0,9001,9001,9001,9001,9001,9001,9001,9001,9001,9001,0,0,0,0,0,0,0,0,9012,9012,9012,9012,9012,9012,9012,0,9014,9014,9014,9014,9014,9014,9014,0,9017,9017,9017,9017,9017,9017,9017,0,0,0,0,0,0,0,0,0,9025,9025,9025,9025,9025,9025,9025,9025,9025,9025,0,0
0,0,9001,9001,9001,9001,9001,9001,9001,9001,9001,9001,0,0,0,0,0,0,0,0,0,0,0,0,0,0,0,0,0,0,9014,9014,9014,9014,9014,0,0,0,0,0,0,0,0,0,0,0,0,0,0,0,0,0,9025,9025,9025,9025,9025,9025,9025,9025,9025,9025,0,0
0,0,9001,9001,0,0,0,0,0,0,9001,9001,0,0,0,0,0,0,0,0,9013,9013,9013,9013,9013,9013,9013,9013,9013,0,9014,9014,9014,9014,9014,0,9016,9016,9016,9016,9016,9016,9016,9016,9016,0,0,0,0,0,0,0,9025,9025,0,0,0,0,0,0,9025,9025,0,0
0,0,9001,9001,0,9002,9002,9002,9002,0,9001,9001,0,0,0,0,0,0,0,0,9013,9013,9013,9013,9013,9013,9013,9013,9013,0,9014,9014,9014,9014,9014,0,9016,9016,9016,9016,9016,9016,9016,9016,9016,0,0,0,0,0,0,0,9025,9025,0,9005,9005,9005,9005,0,9025,9025,0,0
0,0,9001,9001,0,9002,9002,9002,9002,0,9001,9001,0,0,0,0,0,0,0,0,0,0,0,0,0,0,0,0,0,0,9014,9014,9014,9014,9014,0,0,0,0,0,0,0,0,0,0,0,0,0,0,0,0,0,9025,9025,0,9005,9005,9005,9005,0,9025,9025,0,0
0,0,9001,9001,0,9002,9002,9002,9002,0,9001,9001,0,0,0,0,0,0,0,0,0,0,0,0,0,0,0,0,0,0,0,0,0,0,0,0,0,0,0,0,0,0,0,0,0,0,0,0,0,0,0,0,9025,9025,0,9005,9005,9005,9005,0,9025,9025,0,0
0,0,9001,9001,0,9002,9002,9002,9002,0,9001,9001,0,9024,9024,9024,9024,9024,9024,9024,9024,9024,9024,9024,9024,9024,9024,9024,9024,9024,9024,9024,9024,9024,9024,9024,9024,9024,9024,9024,9024,9024,9024,9024,9024,9024,9024,9024,9024,9024,9024,0,9025,9025,0,9005,9005,9005,9005,0,9025,9025,0,0
0,0,9001,9001,0,0,0,0,0,0,9001,9001,0,9024,9024,9024,9024,9024,9024,9024,9024,9024,9024,9024,9024,9024,9024,9024,9024,9024,9024,9024,9024,9024,9024,9024,9024,9024,9024,9024,9024,9024,9024,9024,9024,9024,9024,9024,9024,9024,9024,0,9025,9025,0,0,0,0,0,0,9025,9025,0,0
0,0,9001,9001,9001,9001,9001,9001,9001,9001,9001,9001,0,9024,9024,9024,9024,9024,9024,9024,9024,9024,9024,9024,9024,9024,9024,9024,9024,9024,9024,9024,9024,9024,9024,9024,9024,9024,9024,9024,9024,9024,9024,9024,9024,9024,9024,9024,9024,9024,9024,0,9025,9025,9025,9025,9025,9025,9025,9025,9025,9025,0,0
0,0,9001,9001,9001,9001,9001,9001,9001,9001,9001,9001,0,9024,9024,9024,9024,9024,9024,9024,9024,9024,9024,9024,9024,9024,9024,9024,9024,9024,9024,9024,9024,9024,9024,9024,9024,9024,9024,9024,9024,9024,9024,9024,9024,9024,9024,9024,9024,9024,9024,0,9025,9025,9025,9025,9025,9025,9025,9025,9025,9025,0,0
0,0,0,0,0,0,0,0,0,0,0,0,0,0,0,0,0,0,0,0,0,0,0,0,0,0,0,0,0,0,0,0,0,0,0,0,0,0,0,0,0,0,0,0,0,0,0,0,0,0,0,0,0,0,0,0,0,0,0,0,0,0,0,0
0,0,0,0,0,0,0,0,0,0,0,0,0,0,0,0,0,0,0,0,0,0,0,0,0,0,0,0,0,0,0,0,0,0,0,0,0,0,0,0,0,0,0,0,0,0,0,0,0,0,0,0,0,0,0,0,0,0,0,0,0,0,0,0
