64
1093
1034
0,0,0,0,0,0,0,0,0,0,0,0,0,0,0,0,0,0,0,0,0,0,0,0,0,0,0,0,0,0,0,0,0,0,0,0,0,0,0,0,0,0,0,0,0,0,0,0,0,0,0,0,0,0,0,0,0,0,0,0,0,0,0,0
0,0,0,0,0,0,0,0,0,0,0,0,0,0,0,0,0,0,0,0,0,0,0,0,0,0,0,0,0,0,0,0,0,0,0,0,0,0,0,0,0,0,0,0,0,0,0,0,0,0,0,0,0,0,0,0,0,0,0,0,0,0,0,0
0,0,0,0,0,0,0,0,0,0,0,0,0,0,0,0,0,0,0,0,0,0,0,0,0,0,0,0,0,0,0,0,0,0,0,0,0,0,0,0,0,0,0,0,0,0,0,0,0,0,0,0,0,0,0,0,0,0,0,0,0,0,0,0
0,0,0,0,0,0,0,0,0,0,0,0,0,0,0,0,0,0,0,0,0,0,0,0,0,0,0,0,0,0,0,0,0,0,0,0,0,0,0,0,0,0,0,0,0,0,0,0,0,0,0,0,0,0,0,0,0,0,0,0,0,0,0,0
0,0,0,0,0,0,0,0,0,0,0,0,0,0,0,0,0,0,0,0,0,0,0,0,0,0,0,0,0,0,0,0,0,0,0,0,0,0,0,0,0,0,0,0,0,0,0,0,0,0,0,0,0,0,0,0,0,0,0,0,0,0,0,0
0,0,0,0,0,0,0,0,0,0,0,0,0,0,0,0,0,0,0,0,0,0,0,0,0,0,0,0,0,0,0,0,0,0,0,0,0,0,0,0,0,0,0,0,0,0,0,0,0,0,0,0,0,0,0,0,0,0,0,0,0,0,0,0
0,0,0,0,0,0,0,0,0,0,0,0,0,0,0,0,0,0,0,0,0,0,0,0,0,0,0,0,0,0,0,0,0,0,0,0,0,0,0,0,0,0,0,0,0,0,0,0,0,0,0,0,0,0,0,0,0,0,0,0,0,0,0,0
0,0,0,0,0,0,0,0,0,0,0,0,0,0,0,0,0,0,0,0,0,0,0,0,0,0,0,0,0,0,0,0,0,0,0,0,0,0,0,0,0,0,0,0,0,0,0,0,0,0,0,0,0,0,0,0,0,0,0,0,0,0,0,0
0,0,0,0,0,0,0,0,0,0,0,0,0,0,0,0,0,0,0,0,0,0,0,0,0,0,0,0,0,0,0,0,0,0,0,0,0,0,0,0,0,0,0,0,0,0,0,0,0,0,0,0,0,0,0,0,0,0,0,0,0,0,0,0
0,0,0,0,0,0,0,0,0,0,0,0,0,0,0,0,0,0,0,0,0,0,0,0,1089,1089,1089,1089,1089,1089,1089,1089,1089,1089,1089,1089,0,0,0,0,0,0,0,0,0,0,0,0,0,0,0,0,0,0,0,0,0,0,0,0,0,0,0,0
0,0,0,0,0,0,0,0,0,0,0,0,0,0,1089,1089,1089,1089,1089,1089,1089,1089,1089,1089,1089,5003,0,0,0,5001,0,0,0,0,5003,1089,1089,1089,1089,1089,1089,1089,1089,0,0,0,0,0,0,0,0,0,0,0,0,0,0,0,0,0,0,0,0,0
0,0,0,0,0,0,0,0,0,0,0,0,0,0,1089,5006,0,0,0,0,0,0,0,0,1089,0,0,0,0,0,0,5007,0,0,0,1089,2036,0,0,4007,0,2034,1089,0,0,0,0,0,0,0,0,0,0,0,0,0,0,0,0,0,0,0,0,0
0,0,0,0,0,0,0,0,0,0,0,0,0,0,1089,0,2033,5004,0,0,0,2016,2034,0,3001,0,0,5004,0,0,0,0,5004,0,0,3001,0,2033,0,5004,2036,2005,1089,0,0,0,0,0,0,0,0,0,0,0,0,0,0,0,0,0,0,0,0,0
0,0,0,0,0,0,0,0,0,0,0,0,0,0,1089,0,0,0,0,0,0,0,0,0,1089,0,0,0,5007,0,4005,0,5007,0,0,1089,0,2035,2008,0,2034,0,1089,0,0,0,0,0,0,0,0,0,0,0,0,0,0,0,0,0,0,0,0,0
0,0,0,0,0,0,0,0,0,0,0,0,0,0,1089,0,0,0,0,1089,1089,1089,1089,1089,1089,5003,0,0,0,0,0,0,0,0,5003,1089,2033,0,0,4002,0,2035,1089,0,0,0,0,0,0,0,0,0,0,0,0,0,0,0,0,0,0,0,0,0
0,0,0,0,0,0,0,0,0,0,0,0,0,0,1089,0,0,0,0,1089,0,0,0,0,1089,1089,1089,1089,0,0,0,0,1089,1089,1089,1089,1089,1089,1089,1089,1089,1089,1089,0,0,0,0,0,0,0,0,0,0,0,0,0,0,0,0,0,0,0,0,0
0,0,0,0,0,0,0,0,0,0,0,0,0,0,1089,0,0,5004,0,1089,0,0,0,0,0,0,0,1089,1089,1089,3002,1089,1089,0,0,0,0,0,0,0,0,0,0,0,0,0,0,0,0,0,0,0,0,0,0,0,0,0,0,0,0,0,0,0
0,0,0,0,0,0,0,0,0,0,0,0,0,0,1089,0,0,0,0,1089,0,0,0,0,0,0,0,0,1089,5003,0,5003,1089,0,0,0,0,0,0,0,0,0,0,0,0,0,0,0,0,0,0,0,0,0,0,0,0,0,0,0,0,0,0,0
0,0,0,0,0,0,0,0,0,0,0,0,0,0,1089,0,0,0,0,1089,0,0,0,0,0,0,0,0,1089,0,0,0,1089,0,0,0,0,0,0,0,0,0,0,0,0,0,0,0,0,0,0,0,0,0,0,0,0,0,0,0,0,0,0,0
0,1089,1089,1089,1089,1089,1089,1089,1089,1089,1089,1089,1089,1089,1089,0,0,0,0,1089,1089,1089,1089,0,0,0,0,0,1089,0,5004,0,1089,0,0,0,0,0,0,0,0,0,0,0,0,0,0,0,0,0,0,0,0,0,0,0,0,0,0,0,0,0,0,0
0,1089,0,0,0,4002,1089,5014,0,0,0,0,1089,5014,0,0,0,0,0,0,0,2004,1089,0,0,0,1089,1089,1089,0,0,0,1089,1089,1089,0,0,0,0,0,0,0,0,0,0,0,0,0,0,0,0,0,0,0,0,0,0,0,0,0,0,0,0,0
0,1089,0,2009,0,0,1089,2004,0,0,0,0,3001,0,0,0,0,5004,0,0,0,0,1089,0,0,0,1089,2003,5007,0,0,0,4012,4001,1089,0,0,0,0,0,0,0,0,0,0,0,0,0,0,0,0,0,0,0,0,0,0,0,0,0,0,0,0,0
0,1089,0,5004,0,0,1089,0,0,5004,0,0,1089,5014,0,0,0,0,0,0,0,5006,1089,0,0,0,1089,1089,1089,0,0,0,1089,1089,1089,0,0,0,0,0,0,0,0,0,0,0,0,0,0,0,0,0,0,0,0,0,0,0,0,0,0,0,0,0
0,1089,0,0,0,4012,1089,0,0,0,0,5014,1089,1089,1089,1089,1089,1089,1089,1089,1089,1089,1089,0,0,0,0,0,1089,0,5004,0,1089,0,0,0,0,0,0,0,0,0,0,0,0,0,0,0,0,0,0,0,0,0,0,0,0,0,0,0,0,0,0,0
0,1089,1089,3002,1089,1089,1089,1089,3002,1089,1089,1089,1089,0,0,0,0,0,0,0,0,0,0,0,0,0,0,0,1089,0,0,0,1089,0,0,0,0,0,0,0,0,0,0,0,0,0,0,0,0,0,0,0,0,0,0,0,0,0,0,0,0,0,0,0
0,1090,5006,2002,0,0,1090,4007,0,0,1090,0,0,0,0,0,0,0,0,0,0,0,0,0,0,0,0,0,1089,0,0,0,1089,0,0,0,0,0,0,0,0,0,0,0,0,0,0,0,0,0,0,0,0,0,0,0,0,0,0,0,0,0,0,0
0,1090,0,0,0,0,1090,0,0,0,1090,0,0,0,0,0,0,0,0,0,0,0,0,1091,1091,1091,1091,1091,1091,1091,3002,1091,1091,1091,1091,1091,1091,1091,1091,0,0,0,0,0,1091,1091,1091,1091,1091,1091,1091,1091,1091,1091,0,0,0,0,0,0,0,0,0,0
0,1090,0,0,0,0,1090,0,5004,0,1090,0,0,0,0,0,0,0,0,0,0,0,0,1091,5006,0,0,0,0,0,0,0,0,0,0,0,0,5006,1091,0,0,0,0,0,1091,5011,0,0,0,0,0,4007,4002,1091,0,0,0,0,0,0,0,0,0,0
0,1090,0,0,0,0,1090,0,0,0,1090,0,0,0,0,0,0,0,0,0,0,0,0,1091,0,0,0,0,0,0,0,0,0,0,0,0,0,0,1091,1091,1091,1091,1091,1091,1091,0,2036,0,5008,0,0,2034,0,1091,0,0,0,0,0,0,0,0,0,0
0,1090,0,5004,0,0,1090,1090,3002,1090,1090,1090,1090,1090,1090,1090,1090,1090,1090,0,0,0,0,1091,0,2033,0,2007,0,0,0,0,0,0,0,0,2034,0,1091,0,0,0,0,0,3001,0,0,0,0,5008,0,0,0,1091,0,0,0,0,0,0,0,0,0,0
0,1090,0,0,0,0,1090,0,0,0,0,0,0,0,0,0,0,5014,1090,0,0,0,0,1091,0,2033,0,0,5004,0,0,0,5004,0,0,2008,2034,0,3001,0,0,0,5004,0,1091,0,5008,1000,0,0,0,0,5005,1091,0,0,0,0,0,0,0,0,0,0
0,1090,0,0,0,0,1090,0,0,0,0,0,0,0,0,0,0,0,1090,0,0,0,0,1091,0,0,0,0,0,0,0,0,0,0,0,0,0,0,1091,0,0,0,0,0,1091,0,0,0,5004,0,5008,0,5005,1091,0,0,0,0,0,0,0,0,0,0
0,1090,0,0,0,0,3001,0,2034,0,5004,0,0,0,0,5004,0,2008,1090,0,0,0,0,1091,0,0,0,0,0,0,0,0,0,0,0,0,0,0,1091,1091,1091,0,0,0,1091,2001,0,0,0,0,0,2013,5005,1091,0,0,0,0,0,0,0,0,0,0
0,1090,0,0,0,0,1090,0,0,0,0,0,0,0,0,0,0,0,1090,0,0,0,0,1091,5006,0,0,0,0,0,1000,0,0,0,0,0,0,5006,1091,0,1091,0,0,0,1091,0,2033,0,5008,0,0,2035,5005,1091,0,0,0,0,0,0,0,0,0,0
0,1090,0,0,0,0,1090,0,0,2001,0,0,0,0,0,0,0,5014,1090,0,0,0,0,1091,1091,1091,1091,1091,1091,1091,3002,1091,1091,1091,1091,1091,1091,1091,1091,0,1091,0,5007,0,1091,0,0,0,0,0,5008,0,5005,1091,0,0,0,0,0,0,0,0,0,0
0,1090,0,0,0,0,1090,1090,3002,1090,1090,1090,1090,1090,1090,1090,1090,1090,1090,0,0,0,0,0,0,0,0,0,1088,5002,0,5002,1088,0,0,0,0,0,0,0,1091,0,0,0,1091,1091,1091,1091,1091,1091,1091,1091,1091,1091,0,0,0,0,0,0,0,0,0,0
0,1090,0,0,0,0,1090,0,0,0,1090,0,0,0,0,0,0,0,0,0,0,0,0,0,0,0,0,0,1088,0,3000,0,1088,0,0,0,0,0,0,0,1091,0,0,0,1091,0,0,0,0,0,0,0,4007,1091,0,0,0,0,0,0,0,0,0,0
0,1090,0,0,0,0,1090,0,2009,0,1090,0,0,0,0,0,0,0,0,0,0,0,0,0,0,0,0,0,1088,0,0,0,1088,0,0,0,0,0,0,0,1091,0,5004,0,1091,0,2036,0,0,0,0,2034,0,1091,0,0,0,0,0,0,0,0,0,0
0,1090,0,0,0,0,1090,0,5004,0,1090,0,0,0,0,0,0,0,0,0,0,0,0,0,0,0,0,0,1088,0,2002,0,1088,0,0,0,0,0,0,0,1091,0,0,0,3001,0,0,0,0,5004,0,0,0,1091,0,0,0,0,0,0,0,0,0,0
0,1090,0,5004,0,0,1090,0,0,0,1090,0,0,0,0,0,0,0,0,0,0,0,0,0,0,0,0,0,1088,0,0,0,1088,0,0,0,0,0,0,0,1091,0,0,0,1091,0,2033,0,0,0,2007,2035,0,1091,0,0,0,0,0,0,0,0,0,0
0,1090,0,0,0,0,1090,1090,3002,1090,1090,1090,1090,1090,1090,1090,0,0,0,0,0,0,0,0,0,0,0,0,1088,0,0,0,1088,0,0,0,0,0,0,0,1091,0,2001,0,1091,0,0,0,0,0,0,0,4012,1091,0,0,0,0,0,0,0,0,0,0
0,1090,0,0,0,0,0,0,0,0,0,0,0,0,0,1090,1090,1090,1090,1090,1090,1090,0,0,0,0,0,0,1088,0,5004,0,1088,0,0,0,0,0,0,0,1091,1091,1091,1091,1091,1091,1091,1091,1091,1091,1091,1091,1091,1091,0,0,0,0,0,0,0,0,0,0
0,1090,0,0,0,0,0,0,0,0,0,0,0,0,2004,1090,0,0,1012,1012,1012,1090,0,0,0,0,0,0,1088,0,0,0,1088,0,0,0,0,0,0,0,0,0,0,0,0,0,0,0,0,0,0,0,0,0,0,0,0,0,0,0,0,0,0,0
0,1090,0,0,0,0,5004,0,0,0,0,5004,0,0,0,3001,2020,5004,3001,4011,1012,1090,0,0,0,0,0,0,1088,0,0,0,1088,0,0,0,0,0,0,0,0,0,0,0,0,0,0,0,0,0,0,0,0,0,0,0,0,0,0,0,0,0,0,0
0,1090,5006,0,0,0,0,0,0,0,0,0,0,0,0,1090,0,0,1012,1012,1012,1090,0,0,0,0,0,0,1088,0,0,0,1088,0,0,0,0,0,0,0,0,0,0,0,0,0,0,0,0,0,0,0,0,0,0,0,0,0,0,0,0,0,0,0
0,1090,1090,1090,1090,1090,1090,1090,1090,1090,1090,1090,1090,1090,1090,1090,1090,1090,1090,1090,1090,1090,0,0,0,0,0,0,1088,1088,3002,1088,1088,0,0,0,0,0,0,0,0,0,0,0,0,0,0,0,0,0,0,0,0,0,0,0,0,0,0,0,0,0,0,0
0,0,0,0,0,0,0,0,0,0,0,0,0,0,0,0,0,0,0,0,0,0,1088,1088,1088,1088,1088,1088,1088,0,0,0,1088,1088,1088,1088,1088,1088,0,0,0,0,0,0,0,0,0,0,0,0,0,0,0,0,0,0,0,0,0,0,0,0,0,0
0,0,0,0,0,0,0,0,0,0,0,0,0,0,0,0,0,0,0,0,0,0,1088,0,0,0,0,0,1088,0,5007,0,1088,0,0,0,0,1088,0,0,0,0,0,0,0,0,0,0,0,0,0,0,0,0,0,0,0,0,0,0,0,0,0,0
0,0,0,0,0,0,0,0,0,0,0,0,0,0,0,0,0,0,0,0,0,0,1088,4001,0,5001,0,0,3001,0,0,0,3001,0,5001,0,4001,1088,0,0,0,0,0,0,0,0,0,0,0,0,0,0,0,0,0,0,0,0,0,0,0,0,0,0
0,0,0,0,0,0,0,0,0,0,0,0,0,0,0,0,0,0,0,0,0,0,1088,0,0,0,0,0,1088,0,0,0,1088,0,0,0,0,1088,0,0,0,0,0,0,0,0,0,0,0,0,0,0,0,0,0,0,0,0,0,0,0,0,0,0
0,0,0,0,0,0,0,0,0,0,0,0,0,0,0,0,0,0,0,0,0,0,1088,1088,1088,1088,1088,1088,1088,0,0,0,1088,1088,1088,1088,1088,1088,0,0,0,0,0,0,0,0,0,0,0,0,0,0,0,0,0,0,0,0,0,0,0,0,0,0
0,0,0,0,0,0,0,0,0,0,0,0,0,0,0,0,0,0,0,0,0,0,1088,0,0,0,0,5001,1088,0,0,0,1088,0,0,0,0,1088,0,0,0,0,0,0,0,0,0,0,0,0,0,0,0,0,0,0,0,0,0,0,0,0,0,0
0,0,0,0,0,0,0,0,0,0,0,0,0,0,0,0,0,0,0,0,0,0,1088,4010,0,5004,0,0,3001,0,5004,0,3001,0,5001,0,2004,1088,0,0,0,0,0,0,0,0,0,0,0,0,0,0,0,0,0,0,0,0,0,0,0,0,0,0
0,0,0,0,0,0,0,0,0,0,0,0,0,0,0,0,0,0,0,0,0,0,1088,0,0,0,0,4012,1088,0,0,0,1088,0,0,0,4007,1088,0,0,0,0,0,0,0,0,0,0,0,0,0,0,0,0,0,0,0,0,0,0,0,0,0,0
0,0,0,0,0,0,0,0,0,0,0,0,0,0,0,0,0,0,0,0,0,0,1088,1088,1088,1088,1088,1088,1088,0,0,0,1088,1088,1088,1088,1088,1088,0,0,0,0,0,0,0,0,0,0,0,0,0,0,0,0,0,0,0,0,0,0,0,0,0,0
0,0,0,0,0,0,0,0,0,0,0,0,0,0,0,0,0,0,0,0,0,0,1088,2003,0,0,0,0,0,0,0,0,0,0,0,0,0,1088,0,0,0,0,0,0,0,0,0,0,0,0,0,0,0,0,0,0,0,0,0,0,0,0,0,0
0,0,0,0,0,0,0,0,0,0,0,0,0,0,0,0,0,0,0,0,0,0,1088,0,0,5004,0,0,0,0,0,0,0,0,5004,0,0,1088,0,0,0,0,0,0,0,0,0,0,0,0,0,0,0,0,0,0,0,0,0,0,0,0,0,0
0,0,0,0,0,0,0,0,0,0,0,0,0,0,0,0,0,0,0,0,0,0,1088,0,0,0,0,0,5007,0,0,0,0,0,0,0,0,1088,0,0,0,0,0,0,0,0,0,0,0,0,0,0,0,0,0,0,0,0,0,0,0,0,0,0
0,0,0,0,0,0,0,0,0,0,0,0,0,0,0,0,0,0,0,0,0,0,1088,5003,0,0,0,0,0,0,0,0,0,0,0,0,5003,1088,0,0,0,0,0,0,0,0,0,0,0,0,0,0,0,0,0,0,0,0,0,0,0,0,0,0
0,0,0,0,0,0,0,0,0,0,0,0,0,0,0,0,0,0,0,0,0,0,1088,1088,1088,1088,1088,1088,1088,1088,1088,1088,1088,1088,1088,1088,1088,1088,0,0,0,0,0,0,0,0,0,0,0,0,0,0,0,0,0,0,0,0,0,0,0,0,0,0
0,0,0,0,0,0,0,0,0,0,0,0,0,0,0,0,0,0,0,0,0,0,0,0,0,0,0,0,0,0,0,0,0,0,0,0,0,0,0,0,0,0,0,0,0,0,0,0,0,0,0,0,0,0,0,0,0,0,0,0,0,0,0,0
0,0,0,0,0,0,0,0,0,0,0,0,0,0,0,0,0,0,0,0,0,0,0,0,0,0,0,0,0,0,0,0,0,0,0,0,0,0,0,0,0,0,0,0,0,0,0,0,0,0,0,0,0,0,0,0,0,0,0,0,0,0,0,0
0,0,0,0,0,0,0,0,0,0,0,0,0,0,0,0,0,0,0,0,0,0,0,0,0,0,0,0,0,0,0,0,0,0,0,0,0,0,0,0,0,0,0,0,0,0,0,0,0,0,0,0,0,0,0,0,0,0,0,0,0,0,0,0
0,0,0,0,0,0,0,0,0,0,0,0,0,0,0,0,0,0,0,0,0,0,0,0,0,0,0,0,0,0,0,0,0,0,0,0,0,0,0,0,0,0,0,0,0,0,0,0,0,0,0,0,0,0,0,0,0,0,0,0,0,0,0,0

0,0,0,0,0,0,0,0,0,0,0,0,0,0,0,0,0,0,0,0,0,0,0,0,0,0,0,0,0,0,0,0,0,0,0,0,0,0,0,0,0,0,0,0,0,0,0,0,0,0,0,0,0,0,0,0,0,0,0,0,0,0,0,0
0,0,0,0,0,0,0,0,0,0,0,0,0,0,0,0,0,0,0,0,0,0,0,0,0,0,0,0,0,0,0,0,0,0,0,0,0,0,0,0,0,0,0,0,0,0,0,0,0,0,0,0,0,0,0,0,0,0,0,0,0,0,0,0
0,0,0,0,0,0,0,0,0,0,0,0,0,0,0,0,0,0,0,0,0,0,0,0,0,0,0,0,0,0,0,0,0,0,0,0,0,0,0,0,0,0,0,0,0,0,0,0,0,0,0,0,0,0,0,0,0,0,0,0,0,0,0,0
0,0,0,0,0,0,0,0,0,0,0,0,0,0,0,0,0,0,0,0,0,0,0,0,0,0,0,0,0,0,0,0,0,0,0,0,0,0,0,0,0,0,0,0,0,0,0,0,0,0,0,0,0,0,0,0,0,0,0,0,0,0,0,0
0,0,0,0,0,0,0,0,0,0,0,0,0,0,0,0,0,0,0,0,0,0,0,0,0,0,0,0,0,0,0,0,0,0,0,0,0,0,0,0,0,0,0,0,0,0,0,0,0,0,0,0,0,0,0,0,0,0,0,0,0,0,0,0
0,0,0,0,0,0,0,0,0,0,0,0,0,0,0,0,0,0,0,0,0,0,0,0,0,0,0,0,0,0,0,0,0,0,0,0,0,0,0,0,0,0,0,0,0,0,0,0,0,0,0,0,0,0,0,0,0,0,0,0,0,0,0,0
0,0,0,0,0,0,0,0,0,0,0,0,0,0,0,0,0,0,0,0,0,0,0,0,0,0,0,0,0,0,0,0,0,0,0,0,0,0,0,0,0,0,0,0,0,0,0,0,0,0,0,0,0,0,0,0,0,0,0,0,0,0,0,0
0,0,0,0,0,0,0,0,0,0,0,0,0,0,0,0,0,0,0,0,0,0,0,0,0,0,0,0,0,0,0,0,0,0,0,0,0,0,0,0,0,0,0,0,0,0,0,0,0,0,0,0,0,0,0,0,0,0,0,0,0,0,0,0
0,0,0,0,0,0,0,0,0,0,0,0,0,0,0,0,0,0,0,0,0,0,0,0,0,0,0,0,0,0,0,0,0,0,0,0,0,0,0,0,0,0,0,0,0,0,0,0,0,0,0,0,0,0,0,0,0,0,0,0,0,0,0,0
0,0,0,0,0,0,0,0,0,0,0,0,0,0,0,0,0,0,0,0,0,0,0,0,0,0,0,0,0,0,0,0,0,0,0,0,0,0,0,0,0,0,0,0,0,0,0,0,0,0,0,0,0,0,0,0,0,0,0,0,0,0,0,0
0,0,0,0,0,0,0,0,0,0,0,0,0,0,0,0,0,0,0,0,0,0,0,0,0,9006,9006,9006,9006,9006,9006,9006,9006,9006,9006,0,0,0,0,0,0,0,0,0,0,0,0,0,0,0,0,0,0,0,0,0,0,0,0,0,0,0,0,0
0,0,0,0,0,0,0,0,0,0,0,0,0,0,0,9008,9008,9008,9008,9008,9008,9008,9008,9008,0,9006,9006,9006,9006,9006,9006,9006,9006,9006,9006,0,9007,9007,9007,9007,9007,9007,0,0,0,0,0,0,0,0,0,0,0,0,0,0,0,0,0,0,0,0,0,0
0,0,0,0,0,0,0,0,0,0,0,0,0,0,0,9008,9008,9008,9008,9008,9008,9008,9008,9008,0,9006,9006,9006,9006,9006,9006,9006,9006,9006,9006,0,9007,9007,9007,9007,9007,9007,0,0,0,0,0,0,0,0,0,0,0,0,0,0,0,0,0,0,0,0,0,0
0,0,0,0,0,0,0,0,0,0,0,0,0,0,0,9008,9008,9008,9008,9008,9008,9008,9008,9008,0,9006,9006,9006,9006,9006,9006,9006,9006,9006,9006,0,9007,9007,9007,9007,9007,9007,0,0,0,0,0,0,0,0,0,0,0,0,0,0,0,0,0,0,0,0,0,0
0,0,0,0,0,0,0,0,0,0,0,0,0,0,0,9008,9008,9008,9008,0,0,0,0,0,0,9006,9006,9006,9006,9006,9006,9006,9006,9006,9006,0,9007,9007,9007,9007,9007,9007,0,0,0,0,0,0,0,0,0,0,0,0,0,0,0,0,0,0,0,0,0,0
0,0,0,0,0,0,0,0,0,0,0,0,0,0,0,9008,9008,9008,9008,0,0,0,0,0,0,0,0,0,9006,9006,9006,9006,0,0,0,0,0,0,0,0,0,0,0,0,0,0,0,0,0,0,0,0,0,0,0,0,0,0,0,0,0,0,0,0
0,0,0,0,0,0,0,0,0,0,0,0,0,0,0,9008,9008,9008,9008,0,0,0,0,0,0,0,0,0,0,0,0,0,0,0,0,0,0,0,0,0,0,0,0,0,0,0,0,0,0,0,0,0,0,0,0,0,0,0,0,0,0,0,0,0
0,0,0,0,0,0,0,0,0,0,0,0,0,0,0,9008,9008,9008,9008,0,0,0,0,0,0,0,0,0,0,9005,9005,9005,0,0,0,0,0,0,0,0,0,0,0,0,0,0,0,0,0,0,0,0,0,0,0,0,0,0,0,0,0,0,0,0
0,0,0,0,0,0,0,0,0,0,0,0,0,0,0,9008,9008,9008,9008,0,0,0,0,0,0,0,0,0,0,9005,9005,9005,0,0,0,0,0,0,0,0,0,0,0,0,0,0,0,0,0,0,0,0,0,0,0,0,0,0,0,0,0,0,0,0
0,0,0,0,0,0,0,0,0,0,0,0,0,0,0,9008,9008,9008,9008,0,0,0,0,0,0,0,0,0,0,9005,9005,9005,0,0,0,0,0,0,0,0,0,0,0,0,0,0,0,0,0,0,0,0,0,0,0,0,0,0,0,0,0,0,0,0
0,0,9013,9013,9013,9013,0,9009,9009,9009,9009,9009,0,9008,9008,9008,9008,9008,9008,9008,9008,9008,0,0,0,0,0,0,0,9005,9005,9005,0,0,0,0,0,0,0,0,0,0,0,0,0,0,0,0,0,0,0,0,0,0,0,0,0,0,0,0,0,0,0,0
0,0,9013,9013,9013,9013,0,9009,9009,9009,9009,9009,0,9008,9008,9008,9008,9008,9008,9008,9008,9008,0,0,0,0,0,9005,9005,9005,9005,9005,9005,9005,0,0,0,0,0,0,0,0,0,0,0,0,0,0,0,0,0,0,0,0,0,0,0,0,0,0,0,0,0,0
0,0,9013,9013,9013,9013,0,9009,9009,9009,9009,9009,0,9008,9008,9008,9008,9008,9008,9008,9008,9008,0,0,0,0,0,0,0,9005,9005,9005,0,0,0,0,0,0,0,0,0,0,0,0,0,0,0,0,0,0,0,0,0,0,0,0,0,0,0,0,0,0,0,0
0,0,9013,9013,9013,9013,0,9009,9009,9009,9009,9009,0,0,0,0,0,0,0,0,0,0,0,0,0,0,0,0,0,9005,9005,9005,0,0,0,0,0,0,0,0,0,0,0,0,0,0,0,0,0,0,0,0,0,0,0,0,0,0,0,0,0,0,0,0
0,0,0,0,0,0,0,0,0,0,0,0,0,0,0,0,0,0,0,0,0,0,0,0,0,0,0,0,0,9005,9005,9005,0,0,0,0,0,0,0,0,0,0,0,0,0,0,0,0,0,0,0,0,0,0,0,0,0,0,0,0,0,0,0,0
0,0,9014,9014,9014,9014,0,9010,9010,9010,0,0,0,0,0,0,0,0,0,0,0,0,0,0,0,0,0,0,0,9005,9005,9005,0,0,0,0,0,0,0,0,0,0,0,0,0,0,0,0,0,0,0,0,0,0,0,0,0,0,0,0,0,0,0,0
0,0,9014,9014,9014,9014,0,9010,9010,9010,0,0,0,0,0,0,0,0,0,0,0,0,0,0,0,0,0,0,0,0,0,0,0,0,0,0,0,0,0,0,0,0,0,0,0,0,0,0,0,0,0,0,0,0,0,0,0,0,0,0,0,0,0,0
0,0,9014,9014,9014,9014,0,9010,9010,9010,0,0,0,0,0,0,0,0,0,0,0,0,0,0,9003,9003,9003,9003,9003,9003,9003,9003,9003,9003,9003,9003,9003,9003,0,0,0,0,0,0,0,9016,9016,9016,9016,9016,9016,9016,9016,0,0,0,0,0,0,0,0,0,0,0
0,0,9014,9014,9014,9014,0,9010,9010,9010,0,0,0,0,0,0,0,0,0,0,0,0,0,0,9003,9003,9003,9003,9003,9003,9003,9003,9003,9003,9003,9003,9003,9003,0,0,0,0,0,0,0,9016,9016,9016,9016,9016,9016,9016,9016,0,0,0,0,0,0,0,0,0,0,0
0,0,9014,9014,9014,9014,0,0,0,0,0,0,0,0,0,0,0,0,0,0,0,0,0,0,9003,9003,9003,9003,9003,9003,9003,9003,9003,9003,9003,9003,9003,9003,0,9004,9004,9004,9004,9004,0,9016,9016,9016,9016,9016,9016,9016,9016,0,0,0,0,0,0,0,0,0,0,0
0,0,9014,9014,9014,9014,0,9011,9011,9011,9011,9011,9011,9011,9011,9011,9011,9011,0,0,0,0,0,0,9003,9003,9003,9003,9003,9003,9003,9003,9003,9003,9003,9003,9003,9003,0,9004,9004,9004,9004,9004,0,9016,9016,9016,9016,9016,9016,9016,9016,0,0,0,0,0,0,0,0,0,0,0
0,0,9014,9014,9014,9014,0,9011,9011,9011,9011,9011,9011,9011,9011,9011,9011,9011,0,0,0,0,0,0,9003,9003,9003,9003,9003,9003,9003,9003,9003,9003,9003,9003,9003,9003,0,9004,9004,9004,9004,9004,0,9016,9016,9016,9016,9016,9016,9016,9016,0,0,0,0,0,0,0,0,0,0,0
0,0,9014,9014,9014,9014,0,9011,9011,9011,9011,9011,9011,9011,9011,9011,9011,9011,0,0,0,0,0,0,9003,9003,9003,9003,9003,9003,9003,9003,9003,9003,9003,9003,9003,9003,0,0,0,9004,9004,9004,0,9016,9016,9016,9016,9016,9016,9016,9016,0,0,0,0,0,0,0,0,0,0,0
0,0,9014,9014,9014,9014,0,9011,9011,9011,9011,9011,9011,9011,9011,9011,9011,9011,0,0,0,0,0,0,9003,9003,9003,9003,9003,9003,9003,9003,9003,9003,9003,9003,9003,9003,0,0,0,9004,9004,9004,0,9016,9016,9016,9016,9016,9016,9016,9016,0,0,0,0,0,0,0,0,0,0,0
0,0,9014,9014,9014,9014,0,9011,9011,9011,9011,9011,9011,9011,9011,9011,9011,9011,0,0,0,0,0,0,0,0,0,0,0,0,0,0,0,0,0,0,0,0,0,0,0,9004,9004,9004,0,9016,9016,9016,9016,9016,9016,9016,9016,0,0,0,0,0,0,0,0,0,0,0
0,0,9014,9014,9014,9014,0,0,0,0,0,0,0,0,0,0,0,0,0,0,0,0,0,0,0,0,0,0,0,9002,9002,9002,0,0,0,0,0,0,0,0,0,9004,9004,9004,0,0,0,0,0,0,0,0,0,0,0,0,0,0,0,0,0,0,0,0
0,0,9014,9014,9014,9014,0,9012,9012,9012,0,0,0,0,0,0,0,0,0,0,0,0,0,0,0,0,0,0,0,9002,9002,9002,0,0,0,0,0,0,0,0,0,9004,9004,9004,0,9017,9017,9017,9017,9017,9017,9017,9017,0,0,0,0,0,0,0,0,0,0,0
0,0,9014,9014,9014,9014,0,9012,9012,9012,0,0,0,0,0,0,0,0,0,0,0,0,0,0,0,0,0,0,0,9002,9002,9002,0,0,0,0,0,0,0,0,0,9004,9004,9004,0,9017,9017,9017,9017,9017,9017,9017,9017,0,0,0,0,0,0,0,0,0,0,0
0,0,9014,9014,9014,9014,0,9012,9012,9012,0,0,0,0,0,0,0,0,0,0,0,0,0,0,0,0,0,0,0,9002,9002,9002,0,0,0,0,0,0,0,0,0,9004,9004,9004,0,9017,9017,9017,9017,9017,9017,9017,9017,0,0,0,0,0,0,0,0,0,0,0
0,0,9014,9014,9014,9014,0,9012,9012,9012,0,0,0,0,0,0,0,0,0,0,0,0,0,0,0,0,0,0,0,9002,9002,9002,0,0,0,0,0,0,0,0,0,9004,9004,9004,0,9017,9017,9017,9017,9017,9017,9017,9017,0,0,0,0,0,0,0,0,0,0,0
0,0,9014,9014,9014,9014,0,0,0,0,0,0,0,0,0,0,0,0,0,0,0,0,0,0,0,0,0,0,0,9002,9002,9002,0,0,0,0,0,0,0,0,0,9004,9004,9004,0,9017,9017,9017,9017,9017,9017,9017,9017,0,0,0,0,0,0,0,0,0,0,0
0,0,9014,9014,9014,9014,9014,9014,9014,9014,9014,9014,9014,9014,9014,0,0,0,0,0,0,0,0,0,0,0,0,0,0,9002,9002,9002,0,0,0,0,0,0,0,0,0,0,0,0,0,0,0,0,0,0,0,0,0,0,0,0,0,0,0,0,0,0,0,0
0,0,9014,9014,9014,9014,9014,9014,9014,9014,9014,9014,9014,9014,9014,0,9015,9015,0,0,0,0,0,0,0,0,0,0,0,9002,9002,9002,0,0,0,0,0,0,0,0,0,0,0,0,0,0,0,0,0,0,0,0,0,0,0,0,0,0,0,0,0,0,0,0
0,0,9014,9014,9014,9014,9014,9014,9014,9014,9014,9014,9014,9014,9014,0,9015,9015,0,0,0,0,0,0,0,0,0,0,0,9002,9002,9002,0,0,0,0,0,0,0,0,0,0,0,0,0,0,0,0,0,0,0,0,0,0,0,0,0,0,0,0,0,0,0,0
0,0,9014,9014,9014,9014,9014,9014,9014,9014,9014,9014,9014,9014,9014,0,9015,9015,0,0,0,0,0,0,0,0,0,0,0,9002,9002,9002,0,0,0,0,0,0,0,0,0,0,0,0,0,0,0,0,0,0,0,0,0,0,0,0,0,0,0,0,0,0,0,0
0,0,0,0,0,0,0,0,0,0,0,0,0,0,0,0,0,0,0,0,0,0,0,0,0,0,0,0,0,0,0,0,0,0,0,0,0,0,0,0,0,0,0,0,0,0,0,0,0,0,0,0,0,0,0,0,0,0,0,0,0,0,0,0
0,0,0,0,0,0,0,0,0,0,0,0,0,0,0,0,0,0,0,0,0,0,0,0,0,0,0,0,0,9001,9001,9001,0,0,0,0,0,0,0,0,0,0,0,0,0,0,0,0,0,0,0,0,0,0,0,0,0,0,0,0,0,0,0,0
0,0,0,0,0,0,0,0,0,0,0,0,0,0,0,0,0,0,0,0,0,0,0,9031,9031,9031,9031,9031,0,9001,9001,9001,0,9032,9032,9032,9032,9019,0,0,0,0,0,0,0,0,0,0,0,0,0,0,0,0,0,0,0,0,0,0,0,0,0,0
0,0,0,0,0,0,0,0,0,0,0,0,0,0,0,0,0,0,0,0,0,0,0,9031,9031,9031,9031,9031,0,9001,9001,9001,0,9032,9032,9032,9032,0,0,0,0,0,0,0,0,0,0,0,0,0,0,0,0,0,0,0,0,0,0,0,0,0,0,0
0,0,0,0,0,0,0,0,0,0,0,0,0,0,0,0,0,0,0,0,0,0,0,9031,9031,9031,9031,9031,0,9001,9001,9001,0,9032,9032,9032,9032,0,0,0,0,0,0,0,0,0,0,0,0,0,0,0,0,0,0,0,0,0,0,0,0,0,0,0
0,0,0,0,0,0,0,0,0,0,0,0,0,0,0,0,0,0,0,0,0,0,0,0,0,0,0,0,0,9001,9001,9001,0,0,0,0,0,0,0,0,0,0,0,0,0,0,0,0,0,0,0,0,0,0,0,0,0,0,0,0,0,0,0,0
0,0,0,0,0,0,0,0,0,0,0,0,0,0,0,0,0,0,0,0,0,0,0,9025,9025,9025,9025,9025,0,9001,9001,9001,0,9026,9026,9026,9026,0,0,0,0,0,0,0,0,0,0,0,0,0,0,0,0,0,0,0,0,0,0,0,0,0,0,0
0,0,0,0,0,0,0,0,0,0,0,0,0,0,0,0,0,0,0,0,0,0,0,9025,9025,9025,9025,9025,0,9001,9001,9001,0,9026,9026,9026,9026,0,0,0,0,0,0,0,0,0,0,0,0,0,0,0,0,0,0,0,0,0,0,0,0,0,0,0
0,0,0,0,0,0,0,0,0,0,0,0,0,0,0,0,0,0,0,0,0,0,0,9025,9025,9025,9025,9025,0,9001,9001,9001,0,9026,9026,9026,9026,0,0,0,0,0,0,0,0,0,0,0,0,0,0,0,0,0,0,0,0,0,0,0,0,0,0,0
0,0,0,0,0,0,0,0,0,0,0,0,0,0,0,0,0,0,0,0,0,0,0,0,0,0,0,0,0,9001,9001,9001,0,0,0,0,0,0,0,0,0,0,0,0,0,0,0,0,0,0,0,0,0,0,0,0,0,0,0,0,0,0,0,0
0,0,0,0,0,0,0,0,0,0,0,0,0,0,0,0,0,0,0,0,0,0,0,9001,9001,9001,9001,9001,9001,9001,9001,9001,9001,9001,9001,9001,9001,0,0,0,0,0,0,0,0,0,0,0,0,0,0,0,0,0,0,0,0,0,0,0,0,0,0,0
0,0,0,0,0,0,0,0,0,0,0,0,0,0,0,0,0,0,0,0,0,0,0,9001,9001,9001,9001,9001,9001,9001,9001,9001,9001,9001,9001,9001,9001,0,0,0,0,0,0,0,0,0,0,0,0,0,0,0,0,0,0,0,0,0,0,0,0,0,0,0
0,0,0,0,0,0,0,0,0,0,0,0,0,0,0,0,0,0,0,0,0,0,0,9001,9001,9001,9001,9001,9001,9001,9001,9001,9001,9001,9001,9001,9001,0,0,0,0,0,0,0,0,0,0,0,0,0,0,0,0,0,0,0,0,0,0,0,0,0,0,0
0,0,0,0,0,0,0,0,0,0,0,0,0,0,0,0,0,0,0,0,0,0,0,9001,9001,9001,9001,9001,9001,9001,9001,9001,9001,9001,9001,9001,9001,0,0,0,0,0,0,0,0,0,0,0,0,0,0,0,0,0,0,0,0,0,0,0,0,0,0,0
0,0,0,0,0,0,0,0,0,0,0,0,0,0,0,0,0,0,0,0,0,0,0,0,0,0,0,0,0,0,0,0,0,0,0,0,0,0,0,0,0,0,0,0,0,0,0,0,0,0,0,0,0,0,0,0,0,0,0,0,0,0,0,0
0,0,0,0,0,0,0,0,0,0,0,0,0,0,0,0,0,0,0,0,0,0,0,0,0,0,0,0,0,0,0,0,0,0,0,0,0,0,0,0,0,0,0,0,0,0,0,0,0,0,0,0,0,0,0,0,0,0,0,0,0,0,0,0
0,0,0,0,0,0,0,0,0,0,0,0,0,0,0,0,0,0,0,0,0,0,0,0,0,0,0,0,0,0,0,0,0,0,0,0,0,0,0,0,0,0,0,0,0,0,0,0,0,0,0,0,0,0,0,0,0,0,0,0,0,0,0,0
0,0,0,0,0,0,0,0,0,0,0,0,0,0,0,0,0,0,0,0,0,0,0,0,0,0,0,0,0,0,0,0,0,0,0,0,0,0,0,0,0,0,0,0,0,0,0,0,0,0,0,0,0,0,0,0,0,0,0,0,0,0,0,0
0,0,0,0,0,0,0,0,0,0,0,0,0,0,0,0,0,0,0,0,0,0,0,0,0,0,0,0,0,0,0,0,0,0,0,0,0,0,0,0,0,0,0,0,0,0,0,0,0,0,0,0,0,0,0,0,0,0,0,0,0,0,0,0
