64
1093
1034
0,0,0,0,0,0,0,0,0,0,0,0,0,0,0,0,0,0,0,0,0,0,0,0,0,0,0,0,0,0,0,0,0,0,0,0,0,0,0,0,0,0,0,0,0,0,0,0,0,0,0,0,0,0,0,0,0,0,0,0,0,0,0,0
0,0,0,0,0,0,0,0,0,0,0,0,0,0,0,0,0,0,0,0,0,0,0,0,0,0,0,0,0,0,0,0,0,0,0,0,0,0,0,0,0,0,0,0,0,0,0,0,0,0,0,0,0,0,0,0,0,0,0,0,0,0,0,0
0,0,0,0,0,0,0,0,0,0,0,0,0,0,0,0,0,0,0,0,0,0,0,0,0,0,0,0,0,0,0,0,0,0,0,0,0,0,0,0,0,0,0,0,1082,1082,1082,1082,1082,1082,1082,1082,1082,1082,1082,1082,1082,1082,0,0,0,0,0,0
0,0,0,0,0,0,0,0,0,0,0,0,0,0,0,0,0,0,0,0,0,0,0,0,0,0,0,0,0,0,0,0,0,0,0,0,0,0,0,0,0,0,0,0,1082,4002,4007,4012,1082,0,0,0,0,0,0,0,0,1082,0,0,0,0,0,0
0,0,0,0,0,0,0,0,0,0,0,0,0,0,0,0,0,0,1082,1082,1082,1082,1082,1082,1082,1082,1082,1082,1082,1082,1082,1082,1082,1082,1082,1082,1082,1082,1082,1082,1082,1082,1082,1082,1082,0,0,0,1082,0,0,0,2028,0,0,1012,1012,1012,0,0,0,0,0,0
0,0,0,0,0,0,0,0,0,0,0,0,0,0,0,0,0,0,1082,0,0,0,0,0,0,0,0,0,0,0,0,0,0,0,0,0,0,0,0,0,0,0,0,0,0,0,0,0,3005,0,0,5004,0,0,0,3001,4011,1012,0,0,0,0,0,0
0,0,0,0,0,0,0,0,0,0,0,0,0,0,0,0,0,0,1082,0,5004,0,0,0,0,0,0,0,0,0,0,0,0,5004,0,0,0,0,0,0,0,0,0,0,5004,0,0,2044,1082,0,0,0,2028,0,0,1012,1012,1012,0,0,0,0,0,0
0,0,0,0,0,0,0,0,0,0,0,0,0,0,0,0,0,0,1082,0,0,1082,1082,1082,1082,1082,1082,1082,1082,1082,1082,1082,1082,3002,1082,1082,1082,1082,1082,1082,1082,1082,1082,1082,1082,1082,1082,1082,1082,0,0,0,0,0,0,0,0,1082,0,0,0,0,0,0
0,0,0,0,0,0,0,0,0,0,0,0,0,0,0,0,0,0,1082,0,0,1082,0,0,0,0,0,0,0,0,0,1082,0,0,0,1082,0,0,0,0,0,0,0,0,0,0,0,0,1082,0,0,0,0,0,0,0,0,1082,0,0,0,0,0,0
0,0,0,0,0,0,0,0,0,0,0,0,0,0,0,0,0,0,1082,0,0,1082,0,0,0,0,0,0,0,0,0,1082,0,0,0,1082,0,0,0,0,0,0,0,0,0,0,0,0,1082,0,0,0,0,0,0,0,0,1082,0,0,0,0,0,0
0,0,0,0,0,0,0,0,0,0,0,0,0,0,0,0,0,0,1082,0,0,1082,0,0,0,0,0,0,0,0,0,1082,0,0,0,1082,0,0,0,0,0,0,0,0,0,0,0,0,1082,1082,1082,1082,1082,1082,1082,1082,1082,1082,0,0,0,0,0,0
0,0,0,0,0,0,0,0,0,0,0,0,0,0,0,0,0,0,1082,0,0,1082,0,0,0,0,0,0,0,0,0,1082,0,5004,0,1082,0,0,0,0,0,0,0,0,0,0,0,0,0,0,0,0,0,0,0,0,0,0,0,0,0,0,0,0
0,0,0,0,0,0,0,0,0,0,0,0,0,0,0,0,0,0,1082,0,0,1082,0,0,0,0,0,0,0,0,0,1082,0,0,0,1082,0,0,0,0,0,0,1082,1082,1082,1082,1082,1082,1082,1082,1082,1082,1082,1082,1082,1082,1082,0,0,0,0,0,0,0
0,0,0,0,0,0,0,0,0,0,0,0,0,0,0,0,0,0,1082,0,0,1082,0,0,0,0,0,0,0,0,0,1082,0,0,0,1082,0,0,0,0,0,0,1082,5011,0,0,0,5008,0,4003,4012,0,5008,0,5008,0,1082,0,0,0,0,0,0,0
0,0,0,0,0,0,0,0,0,0,0,0,0,0,0,0,0,0,1082,0,0,1082,0,0,0,0,0,0,0,0,0,1082,0,0,0,1082,1082,1082,1082,1082,1082,1082,1082,0,5004,0,0,0,0,0,5004,0,0,0,0,0,1082,0,0,0,0,0,0,0
0,0,0,0,0,0,0,0,0,0,0,0,0,0,0,0,0,0,1082,0,0,1082,0,0,0,0,0,0,0,0,0,1082,0,5004,0,0,0,0,0,0,4002,4012,1082,0,0,0,0,5008,0,5008,0,0,0,5005,5005,5005,1082,0,0,0,0,0,0,0
0,0,0,0,0,0,0,0,0,0,0,0,0,0,0,0,0,0,1082,0,0,1082,0,0,0,0,0,0,0,0,0,1082,0,0,0,0,0,0,0,0,0,5008,3001,4006,5008,0,2044,0,0,0,0,5008,0,0,4009,5005,1082,0,0,0,0,0,0,0
0,0,0,0,0,0,0,0,0,0,0,0,0,0,0,0,0,0,1082,0,0,1082,0,0,0,0,0,0,0,0,0,1082,1082,1082,1082,1082,1082,1082,1082,1082,1082,1082,1082,0,5004,0,0,5008,0,0,5004,0,0,5005,5005,5005,1082,0,0,0,0,0,0,0
0,0,0,0,0,0,0,0,0,0,0,0,0,0,0,0,0,0,1082,0,0,1082,0,0,0,0,0,0,0,0,0,0,0,0,0,0,0,0,0,0,0,0,1082,0,0,0,5008,0,0,5008,0,0,5008,0,0,0,1082,0,0,0,0,0,0,0
0,0,0,0,0,0,0,0,0,0,0,0,0,0,0,0,0,1082,1082,0,0,1082,1082,0,0,0,0,0,0,0,0,0,0,0,0,0,0,0,0,0,0,0,1082,1082,1082,1082,1082,1082,1082,1082,1082,1082,1082,1082,1082,1082,1082,0,0,0,0,0,0,0
0,0,1083,1083,1083,1083,1083,1083,1083,1083,1083,1083,1083,1083,1083,1083,1083,1083,5003,0,0,5003,1084,1084,1084,1084,1084,1084,1084,1084,1084,1084,0,0,0,0,0,0,0,0,0,0,0,0,1084,1084,1084,1084,1084,1084,1084,1084,1084,1084,1084,1084,1084,1084,1084,1084,1084,1084,0,0
0,0,1083,2002,0,0,1083,0,0,0,5004,0,0,1083,0,2026,0,3003,0,5004,0,0,3001,0,0,0,0,0,0,5006,5006,1084,0,0,0,0,0,0,0,0,0,0,0,0,1084,5014,0,0,0,0,0,0,0,0,0,0,0,0,0,0,4002,1084,0,0
0,0,1083,0,0,0,3001,0,0,0,0,0,2004,1083,0,0,0,1083,5003,0,0,5003,1084,0,0,0,5004,0,0,0,5006,1084,1084,1084,1084,1084,1084,1084,1084,1084,1084,1084,1084,1084,1084,0,2036,0,0,0,0,0,0,0,0,0,0,0,2034,0,0,1084,0,0
0,0,1083,0,5004,0,1083,1083,3002,1083,1083,1083,1083,1083,1083,3002,1083,1083,1082,0,0,1082,1084,0,0,0,0,0,0,0,0,1084,5006,0,0,0,0,0,0,0,0,0,0,4007,1084,0,0,0,0,5004,0,0,0,0,0,5004,0,0,0,0,4007,1084,0,0
0,0,1083,0,0,0,1083,0,0,0,1083,0,2002,1083,4012,0,4002,1083,1082,0,0,1082,1084,0,0,0,2027,0,0,0,0,3001,0,0,5004,0,0,2019,0,0,0,5004,0,0,3001,0,2046,0,0,0,0,0,0,0,0,0,0,0,2045,0,0,1084,0,0
0,0,1083,0,0,0,1083,0,2001,0,1083,0,0,3001,0,5004,0,1083,1082,0,0,1082,1084,0,0,0,0,0,0,0,0,1084,5006,0,0,0,0,0,0,0,0,0,0,4001,1084,0,2033,0,0,0,0,0,0,0,0,0,0,0,2035,0,0,1084,0,0
0,0,1083,3002,1083,1083,1083,1083,3002,1083,1083,1083,0,1083,0,0,0,1083,1082,4002,4007,1082,1084,0,0,0,0,0,0,0,0,1084,1084,1084,1084,1084,1084,1084,1084,1084,1084,1084,1084,1084,1084,5014,0,0,0,0,0,0,0,4007,0,0,0,0,0,0,4002,1084,0,0
0,0,1083,2002,0,1083,0,0,0,0,0,1083,3002,1083,1083,1083,3002,1083,1082,1082,1082,1082,1084,0,0,0,0,0,0,0,0,1084,0,0,0,0,0,0,0,0,0,0,0,0,1084,1084,1084,1084,1084,1084,1084,3002,1084,1084,1084,1084,1084,1084,1084,1084,1084,1084,0,0
0,0,1083,0,0,1083,4002,0,0,0,0,1083,0,0,1083,4007,0,4003,1083,0,0,1084,1084,0,0,0,5004,0,0,0,0,1084,0,0,0,0,0,0,0,0,0,0,0,0,0,0,0,0,0,1087,4002,0,0,4012,1087,0,0,0,0,0,0,0,0,0
0,0,1083,3002,1083,1083,1083,1083,1083,1083,0,3001,0,0,1083,0,0,0,1083,0,0,1084,1084,4012,0,0,0,0,0,0,0,1084,0,0,0,0,0,0,0,0,0,0,0,0,0,0,0,0,0,1087,2036,2036,2036,2036,1087,0,0,0,0,0,0,0,0,0
0,0,1083,0,0,0,0,0,0,1083,2001,1083,0,0,1083,0,2041,0,1083,0,0,1084,1084,4007,4003,0,0,0,0,0,2001,1084,0,0,0,0,0,0,0,0,0,0,0,0,0,0,0,0,0,1087,2014,2014,2014,2014,1087,0,0,0,0,0,0,0,0,0
0,0,1083,1083,1083,1083,1083,3002,1083,1083,1083,1083,1083,1083,1083,1083,1083,1083,1083,0,0,1084,1084,1084,1084,1084,1084,1084,1084,1084,1084,1084,0,0,0,0,0,0,0,0,0,0,0,0,0,0,0,0,0,1087,0,0,0,0,1087,0,0,0,0,0,0,0,0,0
0,0,0,0,0,1092,5003,0,5003,1092,0,0,0,0,0,0,0,0,0,0,0,0,0,0,0,0,0,0,0,0,0,0,0,0,0,0,0,0,0,0,0,0,0,0,0,0,0,0,0,1087,0,5004,0,0,1087,0,0,0,0,0,0,0,0,0
0,0,0,0,0,1092,2036,2036,2036,1092,0,0,0,0,0,1092,1092,1092,1092,1092,1092,1092,1092,1092,1092,0,0,0,0,0,0,0,0,0,0,0,0,0,0,0,0,0,0,0,0,0,0,0,0,1087,0,0,0,0,1087,0,0,0,0,0,0,0,0,0
0,0,0,0,0,1092,2010,2010,2010,1092,0,0,0,0,0,1092,5001,0,0,0,0,5007,0,5001,1092,0,0,0,0,0,0,0,0,0,0,0,0,0,0,0,0,0,0,0,0,0,0,0,0,1087,0,0,0,0,1087,0,0,0,0,0,0,0,0,0
0,0,0,0,0,1092,0,0,0,1092,0,0,0,0,0,1092,0,5007,2026,4008,0,0,5007,0,1092,0,0,0,0,0,0,0,0,0,0,0,0,0,0,0,0,0,0,0,0,0,0,0,0,1087,0,0,0,0,1087,0,0,0,0,0,0,0,0,0
0,0,0,0,0,1092,0,5004,0,1092,0,0,0,0,0,1092,5007,0,0,0,5004,0,0,5007,1092,0,0,0,0,0,0,0,0,0,0,0,0,0,0,0,0,0,0,0,0,0,0,0,0,1087,0,0,0,0,1087,0,0,0,0,0,0,0,0,0
0,0,0,0,0,1092,0,0,0,1092,0,0,0,0,0,1092,0,5001,0,0,0,5001,5007,0,1092,0,0,0,0,0,0,0,0,0,0,0,0,0,0,0,0,0,0,0,0,0,0,0,0,1087,0,0,0,0,1087,0,0,0,0,0,0,0,0,0
0,0,0,0,0,1092,0,0,0,1092,0,0,0,0,0,1092,0,5007,0,5001,0,0,0,0,1092,0,0,0,0,0,0,0,0,0,0,0,0,0,0,0,0,0,0,0,0,0,0,0,0,1087,0,0,0,0,1087,0,0,0,0,0,0,0,0,0
0,0,0,0,0,1092,0,0,0,1092,0,0,0,0,0,1092,5007,0,0,0,0,0,4007,4003,1092,0,0,0,0,0,0,0,0,0,0,0,0,0,0,0,0,0,0,0,0,0,0,0,0,1087,0,5004,0,0,1087,0,0,0,0,0,0,0,0,0
0,0,0,0,0,1092,0,0,0,1092,0,0,0,0,0,1092,1092,1092,3002,1092,1092,1092,1092,1092,1092,1092,1092,1092,1092,1092,1092,1092,0,0,0,0,0,0,0,0,0,0,0,0,0,0,0,0,0,1087,0,0,0,0,1087,0,0,0,0,0,0,0,0,0
0,0,0,0,0,1092,0,0,0,1092,0,0,0,0,0,1092,5007,2018,5007,2018,5007,0,0,0,0,0,5008,0,0,5005,5005,1092,0,0,0,0,0,0,0,0,0,0,0,0,0,0,0,0,0,1087,0,0,0,0,1087,0,0,0,0,0,0,0,0,0
0,0,0,0,0,1092,0,0,0,1092,0,0,0,0,0,1092,5007,5007,5007,5007,5007,0,0,0,0,0,0,0,0,0,5005,1092,1087,1087,1087,1087,1087,1087,1087,1087,1087,1087,1087,0,0,0,0,0,0,1087,0,0,0,0,1087,0,0,0,0,0,0,0,0,0
0,0,0,0,0,1092,0,0,0,1092,0,0,0,0,0,1092,0,0,5007,0,0,0,0,0,0,0,5008,0,5008,0,0,1092,1087,5006,0,0,0,0,0,0,0,5006,1087,0,0,0,0,0,0,1087,2035,2035,2035,2035,1087,0,0,0,0,0,0,0,0,0
0,0,0,0,0,1092,0,0,0,1092,0,0,0,0,0,1092,0,0,2033,0,5004,0,0,2007,0,0,5004,0,2034,0,0,1092,0,0,0,0,0,0,0,0,0,0,1087,0,0,0,0,0,0,1087,0,0,0,0,1087,0,0,0,0,0,0,0,0,0
0,0,0,0,0,1092,0,0,0,1092,0,0,0,0,0,1092,0,0,0,0,0,0,5007,0,0,0,0,0,0,5008,0,3001,0,2036,0,0,0,2016,0,0,2034,0,1087,0,0,0,0,0,0,1087,4007,0,0,4002,1087,0,0,0,0,0,0,0,0,0
0,0,0,0,0,1092,0,5004,0,1092,0,0,0,0,0,1092,0,0,0,0,0,0,0,0,0,0,0,5008,0,0,0,1092,0,0,0,0,0,5004,0,0,0,0,1087,1087,1087,1087,1087,1087,1087,1087,1087,3002,1087,1087,1087,1087,1087,1087,1087,0,0,0,0,0
0,0,0,0,0,1092,0,0,0,1092,0,0,0,0,0,1092,4002,0,4007,0,0,0,0,5007,0,0,0,0,0,0,0,1092,1087,0,0,0,0,0,0,0,0,0,1087,2036,0,0,0,0,0,2007,0,0,0,0,0,0,0,2034,1087,0,0,0,0,0
0,0,0,0,0,1092,0,0,0,1092,0,0,0,0,0,1092,1092,1092,1092,1092,1092,1092,1092,1092,1092,3002,1092,1092,1092,1092,1092,1092,1087,2014,0,0,0,0,0,0,2013,0,3001,0,0,0,0,0,0,0,5004,0,0,0,0,0,0,0,1087,0,0,0,0,0
0,0,0,0,0,1092,0,0,0,1092,0,0,0,0,0,0,0,0,0,0,0,0,0,1092,2036,4012,2034,1092,1087,1087,1087,1087,1087,0,0,0,0,0,0,0,0,0,1087,2033,0,0,2008,0,0,0,0,0,0,2036,0,0,0,0,1087,0,0,0,0,0
0,0,0,0,0,1092,2035,2035,2035,1092,0,0,0,0,0,0,0,0,0,0,0,0,0,1092,0,4006,0,1092,1087,5011,0,0,0,0,0,0,0,5004,0,0,0,0,1087,1087,1087,1087,1087,1087,1087,1087,1087,1087,0,0,0,0,0,0,1087,0,0,0,0,0
0,0,0,0,0,1092,0,0,0,1092,0,0,0,0,0,0,0,0,0,0,0,0,0,1092,0,0,0,1092,1087,4012,0,0,0,0,0,0,0,0,0,0,0,0,1087,0,0,0,0,0,0,0,0,1087,0,0,0,0,0,0,1087,0,0,0,0,0
0,0,0,0,0,1092,4007,0,4001,1092,0,0,0,0,0,0,0,0,0,0,0,0,0,1092,0,5004,0,1092,1087,4007,0,0,5004,2033,0,0,0,2015,0,0,2035,0,1087,0,0,0,0,0,0,0,0,1087,0,0,0,0,0,0,1087,0,0,0,0,0
0,0,0,1092,1092,1092,1092,3002,1092,1092,1092,1092,1092,0,0,0,0,0,0,0,0,0,0,1092,0,5007,0,1092,1087,4002,0,0,0,0,0,0,0,0,0,0,0,5006,1087,0,0,0,0,0,0,0,0,1087,0,0,0,5004,0,0,1087,0,0,0,0,0
0,0,0,1092,4012,5003,0,0,0,5003,0,4002,1092,0,0,0,0,0,0,0,0,0,0,1092,0,0,2013,1092,1087,1087,1087,1087,1087,1087,1087,1087,1087,1087,1087,1087,1087,1087,1087,0,0,0,0,0,0,0,0,1087,0,0,0,0,0,0,1087,0,0,0,0,0
0,0,0,1092,0,0,0,0,0,0,0,0,1092,1092,1092,1092,1092,1092,1092,1092,1092,1092,1092,1092,0,0,0,1092,0,0,0,0,0,0,0,0,0,0,0,0,0,0,0,0,0,0,0,0,0,0,0,1087,0,0,0,0,0,2005,1087,0,0,0,0,0
0,0,0,1092,0,0,0,0,0,0,0,5007,1092,2036,0,0,0,0,0,0,0,0,0,0,2034,0,0,1092,0,0,0,0,0,0,0,0,0,0,0,0,0,0,0,0,0,0,0,0,0,0,0,1087,0,0,0,0,0,0,1087,0,0,0,0,0
0,0,0,1092,0,0,0,5004,0,0,0,5007,3001,0,5007,0,5004,0,0,0,5007,0,0,0,0,5004,0,1092,0,0,0,0,0,0,0,0,0,0,0,0,0,0,0,0,1087,1087,1087,1087,1087,1087,1087,1087,0,0,0,0,0,0,1087,0,0,0,0,0
0,0,0,1092,0,0,0,0,0,0,0,5007,1092,2033,0,0,0,0,2015,0,0,0,0,0,0,0,2035,1092,0,0,0,0,0,0,0,0,0,0,0,0,0,0,0,0,1087,2036,0,0,2007,0,0,0,0,2034,0,0,0,0,1087,0,0,0,0,0
0,0,0,1092,0,0,0,4010,0,0,0,0,1092,1092,1092,1092,1092,1092,1092,1092,1092,1092,1092,1092,1092,1092,1092,1092,0,0,0,0,0,0,0,0,0,0,0,0,0,0,0,0,1087,0,4003,4007,4012,0,0,5004,0,0,0,0,0,0,1087,0,0,0,0,0
0,0,0,1092,4007,0,0,0,0,0,0,4007,1092,0,0,0,0,0,0,0,0,0,0,0,0,0,0,0,0,0,0,0,0,0,0,0,0,0,0,0,0,0,0,0,1087,2033,0,0,0,0,0,2008,0,0,0,0,0,2035,1087,0,0,0,0,0
0,0,0,1092,1092,1092,1092,1092,1092,1092,1092,1092,1092,0,0,0,0,0,0,0,0,0,0,0,0,0,0,0,0,0,0,0,0,0,0,0,0,0,0,0,0,0,0,0,1087,1087,1087,1087,1087,1087,1087,1087,1087,1087,1087,1087,1087,1087,1087,0,0,0,0,0
0,0,0,0,0,0,0,0,0,0,0,0,0,0,0,0,0,0,0,0,0,0,0,0,0,0,0,0,0,0,0,0,0,0,0,0,0,0,0,0,0,0,0,0,0,0,0,0,0,0,0,0,0,0,0,0,0,0,0,0,0,0,0,0
0,0,0,0,0,0,0,0,0,0,0,0,0,0,0,0,0,0,0,0,0,0,0,0,0,0,0,0,0,0,0,0,0,0,0,0,0,0,0,0,0,0,0,0,0,0,0,0,0,0,0,0,0,0,0,0,0,0,0,0,0,0,0,0

0,0,0,0,0,0,0,0,0,0,0,0,0,0,0,0,0,0,0,0,0,0,0,0,0,0,0,0,0,0,0,0,0,0,0,0,0,0,0,0,0,0,0,0,0,0,0,0,0,0,0,0,0,0,0,0,0,0,0,0,0,0,0,0
0,0,0,0,0,0,0,0,0,0,0,0,0,0,0,0,0,0,0,0,0,0,0,0,0,0,0,0,0,0,0,0,0,0,0,0,0,0,0,0,0,0,0,0,0,0,0,0,0,0,0,0,0,0,0,0,0,0,0,0,0,0,0,0
0,0,0,0,0,0,0,0,0,0,0,0,0,0,0,0,0,0,0,0,0,0,0,0,0,0,0,0,0,0,0,0,0,0,0,0,0,0,0,0,0,0,0,0,0,0,0,0,0,0,0,0,0,0,0,0,0,0,0,0,0,0,0,0
0,0,0,0,0,0,0,0,0,0,0,0,0,0,0,0,0,0,0,0,0,0,0,0,0,0,0,0,0,0,0,0,0,0,0,0,0,0,0,0,0,0,0,0,0,9022,9022,9022,0,9023,9023,9023,9023,9023,9023,9023,9023,0,0,0,0,0,0,0
0,0,0,0,0,0,0,0,0,0,0,0,0,0,0,0,0,0,0,0,0,0,0,0,0,0,0,0,0,0,0,0,0,0,0,0,0,0,0,0,0,0,0,0,0,9022,9022,9022,0,9023,9023,9023,9023,9023,9023,9023,9023,0,0,0,0,0,0,0
0,0,0,0,0,0,0,0,0,0,0,0,0,0,0,0,0,0,0,9022,9022,9022,9022,9022,9022,9022,9022,9022,9022,9022,9022,9022,9022,9022,9022,9022,9022,9022,9022,9022,9022,9022,9022,9022,9022,9022,9022,9022,0,9023,9023,9023,9023,9023,9023,9023,9023,0,0,0,0,0,0,0
0,0,0,0,0,0,0,0,0,0,0,0,0,0,0,0,0,0,0,9022,9022,9022,9022,9022,9022,9022,9022,9022,9022,9022,9022,9022,9022,9022,9022,9022,9022,9022,9022,9022,9022,9022,9022,9022,9022,9022,9022,9022,0,9023,9023,9023,9023,9023,9023,9023,9023,0,0,0,0,0,0,0
0,0,0,0,0,0,0,0,0,0,0,0,0,0,0,0,0,0,0,9022,9022,0,0,0,0,0,0,0,0,0,0,0,0,0,0,0,0,0,0,0,0,0,0,0,0,0,0,0,0,9023,9023,9023,9023,9023,9023,9023,9023,0,0,0,0,0,0,0
0,0,0,0,0,0,0,0,0,0,0,0,0,0,0,0,0,0,0,9022,9022,0,0,0,0,0,0,0,0,0,0,0,9024,9024,9024,0,0,0,0,0,0,0,0,0,0,0,0,0,0,9023,9023,9023,9023,9023,9023,9023,9023,0,0,0,0,0,0,0
0,0,0,0,0,0,0,0,0,0,0,0,0,0,0,0,0,0,0,9022,9022,0,0,0,0,0,0,0,0,0,0,0,9024,9024,9024,0,0,0,0,0,0,0,0,0,0,0,0,0,0,9023,9023,9023,9023,9023,9023,9023,9023,0,0,0,0,0,0,0
0,0,0,0,0,0,0,0,0,0,0,0,0,0,0,0,0,0,0,9022,9022,0,0,0,0,0,0,0,0,0,0,0,9024,9024,9024,0,0,0,0,0,0,0,0,0,0,0,0,0,0,0,0,0,0,0,0,0,0,0,0,0,0,0,0,0
0,0,0,0,0,0,0,0,0,0,0,0,0,0,0,0,0,0,0,9022,9022,0,0,0,0,0,0,0,0,0,0,0,9024,9024,9024,0,0,0,0,0,0,0,0,0,0,0,0,0,0,0,0,0,0,0,0,0,0,0,0,0,0,0,0,0
0,0,0,0,0,0,0,0,0,0,0,0,0,0,0,0,0,0,0,9022,9022,0,0,0,0,0,0,0,0,0,0,0,9024,9024,9024,0,0,0,0,0,0,0,0,0,0,0,0,0,0,0,0,0,0,0,0,0,0,0,0,0,0,0,0,0
0,0,0,0,0,0,0,0,0,0,0,0,0,0,0,0,0,0,0,9022,9022,0,0,0,0,0,0,0,0,0,0,0,9024,9024,9024,0,0,0,0,0,0,0,0,9025,9025,9025,9025,9025,9025,9025,9025,9025,9025,9025,9025,9025,0,0,0,0,0,0,0,0
0,0,0,0,0,0,0,0,0,0,0,0,0,0,0,0,0,0,0,9022,9022,0,0,0,0,0,0,0,0,0,0,0,9024,9024,9024,0,0,0,0,0,0,0,0,9025,9025,9025,9025,9025,9025,9025,9025,9025,9025,9025,9025,9025,0,0,0,0,0,0,0,0
0,0,0,0,0,0,0,0,0,0,0,0,0,0,0,0,0,0,0,9022,9022,0,0,0,0,0,0,0,0,0,0,0,9024,9024,9024,9024,9024,9024,9024,9024,9024,9024,0,9025,9025,9025,9025,9025,9025,9025,9025,9025,9025,9025,9025,9025,0,0,0,0,0,0,0,0
0,0,0,0,0,0,0,0,0,0,0,0,0,0,0,0,0,0,0,9022,9022,0,0,0,0,0,0,0,0,0,0,0,9024,9024,9024,9024,9024,9024,9024,9024,9024,9024,0,9025,9025,9025,9025,9025,9025,9025,9025,9025,9025,9025,9025,9025,0,0,0,0,0,0,0,0
0,0,0,0,0,0,0,0,0,0,0,0,0,0,0,0,0,0,0,9022,9022,0,0,0,0,0,0,0,0,0,0,0,0,0,0,0,0,0,0,0,0,0,0,9025,9025,9025,9025,9025,9025,9025,9025,9025,9025,9025,9025,9025,0,0,0,0,0,0,0,0
0,0,0,0,0,0,0,0,0,0,0,0,0,0,0,0,0,0,0,9022,9022,0,0,0,0,0,0,0,0,0,0,0,0,0,0,0,0,0,0,0,0,0,0,9025,9025,9025,9025,9025,9025,9025,9025,9025,9025,9025,9025,9025,0,0,0,0,0,0,0,0
0,0,0,0,0,0,0,0,0,0,0,0,0,0,0,0,0,0,0,9022,9022,0,0,0,0,0,0,0,0,0,0,0,0,0,0,0,0,0,0,0,0,0,0,0,0,0,0,0,0,0,0,0,0,0,0,0,0,0,0,0,0,0,0,0
0,0,0,0,0,0,0,0,0,0,0,0,0,0,0,0,0,0,9022,9022,9022,9022,0,0,0,0,0,0,0,0,0,0,0,0,0,0,0,0,0,0,0,0,0,0,0,0,0,0,0,0,0,0,0,0,0,0,0,0,0,0,0,0,0,0
0,0,0,9014,9014,9014,0,9015,9015,9015,9015,9015,9015,0,9021,9021,9021,0,9022,9022,9022,9022,0,9010,9010,9010,9010,9010,9010,9010,9010,0,0,0,0,0,0,0,0,0,0,0,0,0,0,9008,9008,9008,9008,9008,9008,9008,9008,9008,9008,9008,9008,9008,9008,9008,9008,0,0,0
0,0,0,9014,9014,9014,0,9015,9015,9015,9015,9015,9015,0,9021,9021,9021,0,9022,9022,9022,9022,0,9010,9010,9010,9010,9010,9010,9010,9010,0,0,0,0,0,0,0,0,0,0,0,0,0,0,9008,9008,9008,9008,9008,9008,9008,9008,9008,9008,9008,9008,9008,9008,9008,9008,0,0,0
0,0,0,9014,9014,9014,0,0,0,0,0,0,0,0,0,0,0,0,0,9022,9022,0,0,9010,9010,9010,9010,9010,9010,9010,9010,0,9009,9009,9009,9009,9009,9009,9009,9009,9009,9009,9009,9009,0,9008,9008,9008,9008,9008,9008,9008,9008,9008,9008,9008,9008,9008,9008,9008,9008,0,0,0
0,0,0,9014,9014,9014,0,9016,9016,9016,0,9018,9018,0,9019,9019,9019,0,0,9022,9022,0,0,9010,9010,9010,9010,9010,9010,9010,9010,0,9009,9009,9009,9009,9009,9009,9009,9009,9009,9009,9009,9009,0,9008,9008,9008,9008,9008,9008,9008,9008,9008,9008,9008,9008,9008,9008,9008,9008,0,0,0
0,0,0,9014,9014,9014,0,9016,9016,9016,0,9018,9018,0,9019,9019,9019,0,0,9022,9022,0,0,9010,9010,9010,9010,9010,9010,9010,9010,0,9009,9009,9009,9009,9009,9009,9009,9009,9009,9009,9009,9009,0,9008,9008,9008,9008,9008,9008,9008,9008,9008,9008,9008,9008,9008,9008,9008,9008,0,0,0
0,0,0,0,0,0,0,0,0,0,0,0,9018,0,9019,9019,9019,0,0,9022,9022,0,0,9010,9010,9010,9010,9010,9010,9010,9010,0,0,0,0,0,0,0,0,0,0,0,0,0,0,9008,9008,9008,9008,9008,9008,9008,9008,9008,9008,9008,9008,9008,9008,9008,9008,0,0,0
0,0,0,9013,9013,0,9017,9017,9017,9017,9017,0,9018,0,0,0,0,0,0,0,0,0,0,9010,9010,9010,9010,9010,9010,9010,9010,0,0,0,0,0,0,0,0,0,0,0,0,0,0,0,0,0,0,0,0,0,0,0,0,0,0,0,0,0,0,0,0,0
0,0,0,9013,9013,0,9017,9017,9017,9017,9017,0,9018,9018,0,9020,9020,9020,0,0,0,0,0,9010,9010,9010,9010,9010,9010,9010,9010,0,0,0,0,0,0,0,0,0,0,0,0,0,0,0,0,0,0,0,9007,9007,9007,9007,0,0,0,0,0,0,0,0,0,0
0,0,0,0,0,0,0,0,0,0,9017,0,9018,9018,0,9020,9020,9020,0,0,0,0,0,9010,9010,9010,9010,9010,9010,9010,9010,0,0,0,0,0,0,0,0,0,0,0,0,0,0,0,0,0,0,0,9007,9007,9007,9007,0,0,0,0,0,0,0,0,0,0
0,0,0,9012,9012,9012,9012,9012,9012,0,9017,0,9018,9018,0,9020,9020,9020,0,0,0,0,0,9010,9010,9010,9010,9010,9010,9010,9010,0,0,0,0,0,0,0,0,0,0,0,0,0,0,0,0,0,0,0,9007,9007,9007,9007,0,0,0,0,0,0,0,0,0,0
0,0,0,0,0,0,0,0,0,0,0,0,0,0,0,0,0,0,0,0,0,0,0,0,0,0,0,0,0,0,0,0,0,0,0,0,0,0,0,0,0,0,0,0,0,0,0,0,0,0,9007,9007,9007,9007,0,0,0,0,0,0,0,0,0,0
0,0,0,0,0,0,9011,9011,9011,0,0,0,0,0,0,0,0,0,0,0,0,0,0,0,0,0,0,0,0,0,0,0,0,0,0,0,0,0,0,0,0,0,0,0,0,0,0,0,0,0,9007,9007,9007,9007,0,0,0,0,0,0,0,0,0,0
0,0,0,0,0,0,9011,9011,9011,0,0,0,0,0,0,0,0,0,0,0,0,0,0,0,0,0,0,0,0,0,0,0,0,0,0,0,0,0,0,0,0,0,0,0,0,0,0,0,0,0,9007,9007,9007,9007,0,0,0,0,0,0,0,0,0,0
0,0,0,0,0,0,9011,9011,9011,0,0,0,0,0,0,0,9004,9004,9004,9004,9004,9004,9004,9004,0,0,0,0,0,0,0,0,0,0,0,0,0,0,0,0,0,0,0,0,0,0,0,0,0,0,9007,9007,9007,9007,0,0,0,0,0,0,0,0,0,0
0,0,0,0,0,0,9011,9011,9011,0,0,0,0,0,0,0,9004,9004,9004,9004,9004,9004,9004,9004,0,0,0,0,0,0,0,0,0,0,0,0,0,0,0,0,0,0,0,0,0,0,0,0,0,0,9007,9007,9007,9007,0,0,0,0,0,0,0,0,0,0
0,0,0,0,0,0,9011,9011,9011,0,0,0,0,0,0,0,9004,9004,9004,9004,9004,9004,9004,9004,0,0,0,0,0,0,0,0,0,0,0,0,0,0,0,0,0,0,0,0,0,0,0,0,0,0,9007,9007,9007,9007,0,0,0,0,0,0,0,0,0,0
0,0,0,0,0,0,9011,9011,9011,0,0,0,0,0,0,0,9004,9004,9004,9004,9004,9004,9004,9004,0,0,0,0,0,0,0,0,0,0,0,0,0,0,0,0,0,0,0,0,0,0,0,0,0,0,9007,9007,9007,9007,0,0,0,0,0,0,0,0,0,0
0,0,0,0,0,0,9011,9011,9011,0,0,0,0,0,0,0,9004,9004,9004,9004,9004,9004,9004,9004,0,0,0,0,0,0,0,0,0,0,0,0,0,0,0,0,0,0,0,0,0,0,0,0,0,0,9007,9007,9007,9007,0,0,0,0,0,0,0,0,0,0
0,0,0,0,0,0,9011,9011,9011,0,0,0,0,0,0,0,9004,9004,9004,9004,9004,9004,9004,9004,0,0,0,0,0,0,0,0,0,0,0,0,0,0,0,0,0,0,0,0,0,0,0,0,0,0,9007,9007,9007,9007,0,0,0,0,0,0,0,0,0,0
0,0,0,0,0,0,9011,9011,9011,0,0,0,0,0,0,0,0,0,0,0,0,0,0,0,0,0,0,0,0,0,0,0,0,0,0,0,0,0,0,0,0,0,0,0,0,0,0,0,0,0,9007,9007,9007,9007,0,0,0,0,0,0,0,0,0,0
0,0,0,0,0,0,9011,9011,9011,0,0,0,0,0,0,0,9003,9003,9003,9003,9003,9003,9003,9003,9003,9003,9003,9003,9003,9003,9003,0,0,0,0,0,0,0,0,0,0,0,0,0,0,0,0,0,0,0,9007,9007,9007,9007,0,0,0,0,0,0,0,0,0,0
0,0,0,0,0,0,9011,9011,9011,0,0,0,0,0,0,0,9003,9003,9003,9003,9003,9003,9003,9003,9003,9003,9003,9003,9003,9003,9003,0,0,0,0,0,0,0,0,0,0,0,0,0,0,0,0,0,0,0,9007,9007,9007,9007,0,0,0,0,0,0,0,0,0,0
0,0,0,0,0,0,9011,9011,9011,0,0,0,0,0,0,0,9003,9003,9003,9003,9003,9003,9003,9003,9003,9003,9003,9003,9003,9003,9003,0,0,9005,9005,9005,9005,9005,9005,9005,9005,9005,0,0,0,0,0,0,0,0,9007,9007,9007,9007,0,0,0,0,0,0,0,0,0,0
0,0,0,0,0,0,9011,9011,9011,0,0,0,0,0,0,0,9003,9003,9003,9003,9003,9003,9003,9003,9003,9003,9003,9003,9003,9003,9003,0,9005,9005,9005,9005,9005,9005,9005,9005,9005,9005,0,0,0,0,0,0,0,0,9007,9007,9007,9007,0,0,0,0,0,0,0,0,0,0
0,0,0,0,0,0,9011,9011,9011,0,0,0,0,0,0,0,9003,9003,9003,9003,9003,9003,9003,9003,9003,9003,9003,9003,9003,9003,9003,0,9005,9005,9005,9005,9005,9005,9005,9005,9005,9005,0,0,0,0,0,0,0,0,9007,9007,9007,9007,0,0,0,0,0,0,0,0,0,0
0,0,0,0,0,0,9011,9011,9011,0,0,0,0,0,0,0,9003,9003,9003,9003,9003,9003,9003,9003,9003,9003,9003,9003,9003,9003,9003,0,9005,9005,9005,9005,9005,9005,9005,9005,9005,9005,0,0,0,0,0,0,0,0,0,0,0,0,0,0,0,0,0,0,0,0,0,0
0,0,0,0,0,0,9011,9011,9011,0,0,0,0,0,0,0,9003,9003,9003,9003,9003,9003,9003,9003,9003,9003,9003,9003,9003,9003,9003,0,0,9005,9005,9005,9005,9005,9005,9005,9005,9005,0,9006,9006,9006,9006,9006,9006,9006,9006,9006,9006,9006,9006,9006,9006,9006,0,0,0,0,0,0
0,0,0,0,0,0,9011,9011,9011,0,0,0,0,0,0,0,0,0,0,0,0,0,0,0,0,0,0,0,0,0,0,0,0,9005,9005,9005,9005,9005,9005,9005,9005,9005,0,9006,9006,9006,9006,9006,9006,9006,9006,9006,9006,9006,9006,9006,9006,9006,0,0,0,0,0,0
0,0,0,0,0,0,9011,9011,9011,0,0,0,0,0,0,0,0,0,0,0,0,0,0,0,9002,9002,9002,0,0,0,0,0,0,9005,9005,9005,9005,9005,9005,9005,9005,9005,0,9006,9006,9006,9006,9006,9006,9006,9006,9006,9006,9006,9006,9006,9006,9006,0,0,0,0,0,0
0,0,0,0,0,0,9011,9011,9011,0,0,0,0,0,0,0,0,0,0,0,0,0,0,0,9002,9002,9002,0,0,9005,9005,9005,9005,9005,9005,9005,9005,9005,9005,9005,9005,9005,0,0,0,0,0,0,0,0,0,0,9006,9006,9006,9006,9006,9006,0,0,0,0,0,0
0,0,0,0,0,0,9011,9011,9011,0,0,0,0,0,0,0,0,0,0,0,0,0,0,0,9002,9002,9002,0,0,9005,9005,9005,9005,9005,9005,9005,9005,9005,9005,9005,9005,9005,0,0,0,0,0,0,0,0,0,0,9006,9006,9006,9006,9006,9006,0,0,0,0,0,0
0,0,0,0,0,0,9011,9011,9011,0,0,0,0,0,0,0,0,0,0,0,0,0,0,0,9002,9002,9002,0,0,9005,9005,9005,9005,9005,9005,9005,9005,9005,9005,9005,9005,9005,0,0,0,0,0,0,0,0,0,0,9006,9006,9006,9006,9006,9006,0,0,0,0,0,0
0,0,0,0,0,0,0,0,0,0,0,0,0,0,0,0,0,0,0,0,0,0,0,0,9002,9002,9002,0,0,9005,9005,9005,9005,9005,9005,9005,9005,9005,9005,9005,9005,9005,0,0,0,0,0,0,0,0,0,0,9006,9006,9006,9006,9006,9006,0,0,0,0,0,0
0,0,0,0,9001,9001,9001,9001,9001,9001,9001,9001,0,0,0,0,0,0,0,0,0,0,0,0,9002,9002,9002,0,0,0,0,0,0,0,0,0,0,0,0,0,0,0,0,0,0,0,0,0,0,0,0,0,9006,9006,9006,9006,9006,9006,0,0,0,0,0,0
0,0,0,0,9001,9001,9001,9001,9001,9001,9001,9001,0,0,0,0,0,0,0,0,0,0,0,0,9002,9002,9002,0,0,0,0,0,0,0,0,0,0,0,0,0,0,0,0,0,0,0,0,0,0,0,0,0,9006,9006,9006,9006,9006,9006,0,0,0,0,0,0
0,0,0,0,9001,9001,9001,9001,9001,9001,9001,9001,0,9002,9002,9002,9002,9002,9002,9002,9002,9002,9002,9002,9002,9002,9002,0,0,0,0,0,0,0,0,0,0,0,0,0,0,0,0,0,0,0,0,0,0,0,0,0,9006,9006,9006,9006,9006,9006,0,0,0,0,0,0
0,0,0,0,9001,9001,9001,9001,9001,9001,9001,9001,0,9002,9002,9002,9002,9002,9002,9002,9002,9002,9002,9002,9002,9002,9002,0,0,0,0,0,0,0,0,0,0,0,0,0,0,0,0,0,0,0,0,0,0,0,0,0,9006,9006,9006,9006,9006,9006,0,0,0,0,0,0
0,0,0,0,9001,9001,9001,9001,9001,9001,9001,9001,0,9002,9002,9002,9002,9002,9002,9002,9002,9002,9002,9002,9002,9002,9002,0,0,0,0,0,0,0,0,0,0,0,0,0,0,0,0,0,0,9006,9006,9006,9006,9006,9006,9006,9006,9006,9006,9006,9006,9006,0,0,0,0,0,0
0,0,0,0,9001,9001,9001,9001,9001,9001,9001,9001,0,0,0,0,0,0,0,0,0,0,0,0,0,0,0,0,0,0,0,0,0,0,0,0,0,0,0,0,0,0,0,0,0,9006,9006,9006,9006,9006,9006,9006,9006,9006,9006,9006,9006,9006,0,0,0,0,0,0
0,0,0,0,9001,9001,9001,9001,9001,9001,9001,9001,0,0,0,0,0,0,0,0,0,0,0,0,0,0,0,0,0,0,0,0,0,0,0,0,0,0,0,0,0,0,0,0,0,9006,9006,9006,9006,9006,9006,9006,9006,9006,9006,9006,9006,9006,0,0,0,0,0,0
0,0,0,0,0,0,0,0,0,0,0,0,0,0,0,0,0,0,0,0,0,0,0,0,0,0,0,0,0,0,0,0,0,0,0,0,0,0,0,0,0,0,0,0,0,0,0,0,0,0,0,0,0,0,0,0,0,0,0,0,0,0,0,0
0,0,0,0,0,0,0,0,0,0,0,0,0,0,0,0,0,0,0,0,0,0,0,0,0,0,0,0,0,0,0,0,0,0,0,0,0,0,0,0,0,0,0,0,0,0,0,0,0,0,0,0,0,0,0,0,0,0,0,0,0,0,0,0
0,0,0,0,0,0,0,0,0,0,0,0,0,0,0,0,0,0,0,0,0,0,0,0,0,0,0,0,0,0,0,0,0,0,0,0,0,0,0,0,0,0,0,0,0,0,0,0,0,0,0,0,0,0,0,0,0,0,0,0,0,0,0,0
