64
1001
1001
0,0,0,0,0,0,0,0,0,0,0,0,0,0,0,0,0,0,0,0,0,0,0,0,0,0,0,0,0,0,0,0,0,0,0,0,0,0,0,0,0,0,0,0,0,0,0,0,0,0,0,0,0,0,0,0,0,0,0,0,0,0,0,0
0,1021,1021,1021,1021,1021,1021,1021,1021,1021,1021,1021,1021,1021,1021,1021,1021,1021,1021,1021,1021,1021,1021,1021,1021,1021,1021,1021,1021,1021,1021,1021,1021,1021,1021,1021,1021,1021,1021,1021,1021,1021,1021,1021,1019,1019,1019,1019,1019,1019,1019,1019,1019,1019,1019,1019,1019,1019,1019,1019,1019,1019,1019,0
0,1021,4002,0,0,0,4007,1021,4003,2033,0,2011,0,0,0,0,0,0,0,0,0,0,0,0,0,0,0,0,0,0,0,0,0,2034,4007,1021,4003,4007,4007,1021,4003,0,4007,1021,1019,0,0,0,0,1019,4007,0,0,0,0,0,4003,1019,0,0,0,0,1019,0
0,1021,0,2036,0,2034,0,1021,0,2033,0,2011,0,0,0,0,0,0,0,0,0,0,0,0,0,0,0,0,0,0,0,0,0,2034,0,1021,2036,0,2034,1021,0,2042,0,1021,1019,0,2036,2034,0,1019,0,0,0,4008,0,0,0,1019,0,2036,2034,0,1019,0
0,1021,0,0,0,2017,0,3001,0,2033,0,2011,0,0,0,0,0,0,0,0,0,0,0,0,0,0,0,0,0,0,0,0,0,2034,0,3001,0,0,0,1021,0,0,0,1021,1019,0,0,0,0,1019,0,0,0,0,0,0,0,1019,0,0,0,0,1019,0
0,1021,0,0,0,0,0,1021,0,2033,0,2011,0,0,0,0,0,0,0,0,0,0,0,0,0,0,0,0,0,0,0,0,0,2034,0,1021,0,0,0,1021,0,0,0,1021,1019,0,0,0,0,1019,0,0,0,2018,0,0,0,1019,0,0,0,0,1019,0
0,1021,0,2033,0,2035,0,1021,0,2033,0,2011,0,0,0,0,0,0,0,0,0,0,0,0,0,0,0,0,0,0,0,0,0,2034,0,1021,0,0,0,1021,0,0,0,1021,1019,0,0,0,0,1019,0,0,0,0,0,0,0,1019,0,0,0,0,1019,0
0,1021,4007,0,0,0,0,1021,4007,2033,0,2011,0,0,0,0,0,0,0,0,0,0,0,0,0,0,0,0,0,0,0,0,0,2034,4003,1021,0,0,0,1021,0,0,0,1021,1019,0,0,0,0,1019,0,0,0,0,0,0,0,1019,0,0,0,0,1019,0
0,1021,1021,1021,3002,1021,1021,1021,1021,1021,1021,1021,1021,1021,1021,1021,1001,1001,1021,1021,1021,1021,1021,1021,1021,1021,1021,1021,1021,1021,1021,1021,1021,1021,1021,1021,0,0,0,1021,1021,3002,1021,1021,1019,0,2014,0,0,1019,1019,1019,1019,3002,1019,1019,1019,1019,0,0,2013,0,1019,0
0,1021,4007,0,0,0,4003,1021,0,2036,0,0,2008,0,0,0,2034,0,0,0,0,0,0,0,2036,0,0,0,2008,0,0,0,0,2034,0,1021,0,0,0,0,0,0,0,1021,1019,0,0,0,0,0,0,0,0,0,0,0,0,0,0,0,0,0,1019,0
0,1021,2036,2036,2036,2036,2036,1021,0,0,1021,1021,1021,1021,1021,1021,0,0,1021,1021,1021,1021,1021,1021,0,0,1021,1021,1021,1021,1021,1021,0,0,0,1021,2014,0,2035,0,0,0,2034,1021,1019,0,0,2035,0,0,0,0,0,2016,0,0,0,0,0,2034,0,0,1019,0
0,1021,0,0,0,0,0,1021,0,0,1021,0,2026,0,4003,1021,0,0,1021,0,2026,0,4003,1021,0,0,1021,0,2026,0,4003,1021,0,0,0,1021,0,0,0,0,0,0,0,1021,1019,0,0,0,0,0,0,0,0,0,0,0,0,0,0,0,0,0,1019,0
0,1021,0,0,0,0,0,1021,0,0,1021,0,0,0,0,1021,0,0,1021,0,0,0,0,1021,0,0,1021,0,0,0,0,1021,0,0,0,1021,0,0,0,0,0,0,2013,1021,1019,0,0,0,0,0,0,0,0,0,0,0,0,0,0,0,0,0,1019,0
0,1021,0,0,0,0,0,1021,0,0,1021,0,0,0,0,1021,0,0,1021,0,0,0,0,1021,0,0,1021,0,0,0,0,1021,0,0,0,1021,0,0,0,0,0,0,0,1021,1019,0,0,0,0,0,0,0,0,0,0,0,0,0,0,0,0,0,1019,0
0,1021,0,0,0,0,0,1021,0,0,1021,4007,0,0,0,1021,0,0,1021,4007,0,0,0,1021,0,0,1021,4007,0,0,0,1021,0,0,0,1021,2033,0,0,0,0,0,2035,1021,1019,0,2033,0,0,0,0,0,0,2015,0,0,0,0,0,0,2035,0,1019,0
0,1021,0,0,0,0,0,1021,0,0,1021,1021,3002,1021,1021,1021,0,0,1021,1021,3002,1021,1021,1021,0,0,1021,1021,3002,1021,1021,1021,0,0,0,1021,0,0,0,0,0,0,0,1021,1019,0,0,0,0,0,0,0,0,0,0,0,0,0,0,0,0,0,1019,0
0,1021,0,0,0,0,0,1021,0,2006,0,0,0,0,0,0,2005,0,0,0,0,0,0,0,2006,0,0,0,0,0,0,0,0,2005,0,1021,1021,1021,1021,3002,1021,1021,1021,1021,1019,1019,1019,1019,1019,1019,1019,1019,1019,1019,1019,1019,3002,1019,1019,1019,1019,1019,1019,0
0,1021,0,0,0,0,0,1021,0,0,0,0,0,0,0,0,0,0,0,0,0,0,0,0,0,0,0,0,0,0,0,0,0,0,0,1021,0,0,2010,0,2010,0,0,1021,1019,0,0,2042,0,0,1019,0,0,0,0,2002,0,2002,0,0,0,0,1019,0
0,1021,0,0,0,0,0,1021,0,0,0,0,0,0,0,0,0,0,0,0,0,0,0,0,0,0,0,0,0,0,0,0,0,0,0,1021,0,0,0,0,0,0,0,1021,1019,0,0,0,0,0,1019,0,0,0,0,0,0,0,0,0,0,0,1019,0
0,1021,0,0,0,0,0,1021,0,0,0,0,0,0,0,0,0,0,0,0,0,0,0,0,0,0,0,0,0,0,0,0,0,0,0,1021,0,0,0,0,0,0,0,1021,1019,0,0,0,0,0,1019,0,0,0,0,0,0,0,0,0,0,0,1019,0
0,1021,0,0,0,0,0,1021,0,0,0,0,0,0,0,0,0,0,0,0,0,0,0,0,0,0,0,0,0,0,0,0,0,0,0,1021,0,0,0,0,0,0,0,1021,1019,0,0,0,0,0,1019,0,0,0,0,0,2010,0,0,0,0,0,1019,0
0,1021,0,0,0,0,0,1021,0,2033,0,0,2007,0,0,0,2035,0,0,0,0,0,0,0,2033,0,0,0,2007,0,0,0,0,2035,0,1021,0,0,0,0,0,0,0,1021,1019,1019,1019,1019,1019,1019,1019,0,0,0,0,0,0,0,0,0,0,0,1019,0
0,1021,0,0,0,0,0,1021,0,0,0,0,0,0,0,0,0,0,0,0,0,0,0,0,0,0,0,0,0,0,0,0,0,0,0,1021,0,0,0,0,0,0,0,1021,1019,4003,0,0,0,4007,1019,0,0,0,0,0,0,0,0,0,0,0,1019,0
0,1021,0,0,0,0,0,1021,0,0,0,0,0,0,0,0,0,0,0,0,0,0,0,0,0,0,0,0,0,0,0,0,0,0,0,1021,0,0,0,0,0,0,0,1021,1019,0,0,0,0,0,1019,0,0,0,0,0,0,0,0,0,0,0,1019,0
0,1021,0,0,0,0,0,1021,1021,1021,1021,3002,1021,1021,1021,1021,1021,3002,1021,1021,1021,1021,1021,1021,1021,3002,1021,1021,1021,1021,1021,0,0,0,0,1021,0,0,0,0,0,0,0,1021,1019,0,0,0,0,0,1019,0,0,0,0,0,0,0,0,0,0,0,1019,0
0,1021,0,0,0,0,0,1021,0,0,0,0,0,0,1021,1021,0,0,0,4007,1021,0,0,0,0,0,0,0,0,0,1021,2001,0,0,0,1021,0,0,0,0,0,0,4002,1021,1019,0,0,0,0,0,1019,0,0,0,0,0,0,0,0,0,0,0,1019,0
0,1021,0,0,0,0,0,1021,2036,2036,2036,2036,2036,2036,1021,1021,0,0,0,0,1021,0,0,0,0,0,0,0,0,0,1021,1021,1021,1021,1021,1021,1021,1021,1021,3002,1021,1021,1021,1021,1019,0,0,0,0,0,1019,0,0,0,0,0,0,0,0,0,0,0,1019,0
0,1021,0,0,0,0,0,1021,0,0,0,0,0,0,1021,1021,0,0,0,0,1021,0,0,0,0,0,0,0,0,0,1021,0,0,0,0,0,0,0,0,0,0,0,0,1021,1019,0,0,0,0,0,1019,0,0,0,0,0,0,0,0,0,0,0,1019,0
0,1021,0,0,0,0,0,1021,0,0,0,0,0,0,1021,1021,0,0,0,0,1021,0,0,0,0,0,0,0,0,0,3001,0,2036,0,0,0,0,2008,0,0,0,0,2034,1021,1019,0,0,0,0,0,1019,4001,4007,0,0,0,0,0,0,0,0,4001,1019,0
0,1021,0,0,0,0,0,1021,0,0,0,0,0,0,1021,1021,0,0,0,0,1021,0,0,0,0,0,0,0,0,0,1021,0,0,0,0,0,0,0,0,0,0,0,0,1021,1019,1019,1019,3002,1019,1019,1019,1019,1019,1019,1019,1019,3002,1019,1019,1019,1019,1019,1019,0
0,1021,0,0,0,0,0,1021,0,0,0,0,0,0,1021,1021,0,2041,0,4003,1021,0,0,0,0,0,0,0,0,0,1021,0,2033,0,0,0,0,2036,0,0,0,0,0,1021,1019,0,0,0,0,0,0,0,0,0,0,0,0,0,0,0,0,0,1019,0
0,1021,0,0,0,0,0,1021,0,0,0,0,0,0,1021,1021,1021,1021,1021,1021,1021,1021,1021,0,0,0,0,0,1021,1021,1021,1021,1021,1021,1021,1021,1021,0,0,0,0,0,0,1021,1019,0,2036,0,0,0,0,0,0,2008,0,0,0,0,0,0,2034,0,1019,0
0,1021,0,0,0,0,0,1021,0,0,0,0,0,0,1021,1019,1019,1019,1019,1019,1019,1019,1019,1019,1019,3004,1019,1019,1019,1019,1019,1019,1019,1019,1019,1019,1021,2006,0,0,0,0,0,1021,1019,0,0,0,0,0,0,0,0,0,0,0,0,0,0,0,0,0,1019,0
0,1021,0,0,0,0,0,1021,0,0,0,0,0,0,1021,1019,0,0,0,0,0,0,0,0,0,0,0,0,0,0,0,0,0,0,0,1019,1021,0,0,0,0,0,0,1021,1019,0,2006,0,0,0,0,0,0,0,0,0,0,0,0,0,2005,0,1019,0
0,1021,0,0,0,0,0,1021,0,0,0,0,0,0,1021,1019,0,0,0,0,0,0,0,0,0,0,0,0,0,0,0,0,0,0,0,1019,1021,0,0,0,0,0,2013,1021,1019,0,0,0,0,0,0,0,0,0,0,0,0,0,0,0,0,0,1019,0
0,1021,0,0,0,0,0,1021,0,0,0,0,0,0,1021,1019,0,0,2033,0,0,0,0,0,2007,0,0,0,0,0,0,0,2036,0,0,1019,1021,2033,0,0,4002,0,2035,1021,1019,0,2033,0,0,0,0,0,0,2007,0,0,0,0,0,0,2035,0,1019,0
0,1021,0,0,0,0,0,1021,0,0,0,0,0,0,1021,1019,0,0,0,0,0,0,0,0,0,0,0,0,0,0,0,0,0,0,0,1019,1021,1021,1021,1021,1021,1021,1021,1021,1019,1019,1019,1019,1019,1019,1019,1019,1019,1019,1019,1019,0,0,0,0,0,1019,1019,0
0,1021,0,0,0,0,0,1021,0,0,0,0,0,0,1021,1019,0,0,0,0,0,1019,1019,1019,1019,1019,1019,1019,1019,1019,0,0,0,0,0,1019,1029,1029,1029,1029,1029,1029,1029,1029,1029,1029,1029,1029,1029,1029,1029,1029,1029,1029,1029,1029,1029,1029,3002,1029,1029,1029,1029,0
0,1021,0,0,0,0,0,1021,0,0,0,0,0,0,1021,1019,0,0,0,0,0,1019,0,0,1012,1012,1012,0,0,1019,0,0,2006,0,0,1019,1029,0,0,0,0,0,1029,0,4007,0,0,1029,0,0,0,0,0,1029,0,0,0,0,0,0,0,0,1029,0
0,1021,0,0,0,0,0,1021,0,0,0,0,0,0,1021,1019,0,0,0,0,0,1019,0,0,1012,4011,1012,0,0,1019,0,0,0,0,0,1019,1029,2036,0,0,2036,0,1029,0,0,0,0,1029,0,2018,0,0,4003,1029,0,0,0,0,0,0,0,0,1029,0
0,1021,0,0,0,0,0,1021,0,0,0,0,0,0,1021,1019,0,0,0,0,0,1019,0,0,1012,3002,1012,0,0,1019,0,0,0,0,0,3001,0,2014,0,0,0,0,3001,0,0,0,0,1029,0,0,0,0,0,1029,0,0,0,0,0,0,0,0,1029,0
0,1021,0,0,0,0,0,1021,0,0,0,0,0,0,1021,1019,0,0,0,0,0,1019,0,0,0,0,0,0,0,1019,0,0,0,0,0,1019,1029,0,0,0,0,0,1029,0,0,0,0,1029,0,0,0,0,0,1029,0,0,0,0,2001,0,0,0,1029,0
0,1021,0,0,0,0,0,1021,0,0,0,0,0,0,1021,1019,0,0,0,0,0,1019,0,0,0,2026,0,0,0,1019,0,0,0,0,0,1019,1029,0,0,0,0,0,1029,0,0,0,0,1029,1029,3002,1029,1029,1029,1029,0,0,0,0,0,0,0,0,1029,0
0,1021,0,0,0,0,0,1021,0,0,0,0,0,0,1021,1019,0,0,0,0,0,1019,1019,1019,0,0,0,1019,1019,1019,0,0,0,0,0,1019,1029,0,0,0,0,0,1029,0,0,0,0,0,0,0,0,0,0,1029,0,0,0,0,0,0,0,0,1029,0
0,1021,0,0,0,0,0,1021,2014,2014,2014,2014,2014,2014,1021,1019,0,0,0,0,0,1019,0,1019,0,0,0,1019,0,1019,0,0,0,0,0,1019,1029,0,0,0,0,0,1029,0,2036,0,0,0,0,0,0,2034,0,1029,4007,0,0,0,0,0,0,0,1029,0
0,1021,0,0,0,0,0,1021,2035,2035,2035,2035,2035,2035,1021,1019,0,0,0,0,0,1019,0,1019,4003,0,4003,1019,0,1019,0,0,0,0,0,1019,1029,0,0,0,0,0,1029,0,0,0,0,0,0,0,0,0,0,1029,1029,1029,1029,1029,3002,1029,1029,1029,1029,0
0,1021,0,0,0,0,0,1021,0,0,0,0,0,4002,1021,1019,0,0,0,0,0,1019,3002,1019,1019,3006,1019,1019,3002,1019,0,0,0,0,0,1019,1029,0,0,0,0,0,1029,0,0,0,0,0,0,0,0,0,0,1029,0,0,0,0,0,0,0,4002,1029,0
0,1021,0,0,0,0,0,1021,1001,1001,1001,3002,1001,1001,1021,1019,0,0,0,0,0,0,0,0,0,0,0,0,0,0,0,0,0,0,0,1019,1029,0,0,0,0,0,1029,0,0,0,0,0,0,0,0,0,0,1029,0,0,0,0,0,0,0,0,1029,0
0,1021,0,0,0,0,0,1021,0,0,0,0,0,4002,1021,1019,0,0,2005,0,0,0,0,0,0,0,0,0,0,0,0,0,0,0,0,3001,0,0,0,0,0,0,3001,0,0,0,0,0,0,0,0,0,0,1029,0,0,0,0,0,0,0,0,1029,0
0,1021,0,0,0,0,0,1021,0,0,0,0,0,0,1021,1019,0,0,2035,0,0,0,0,0,0,0,0,2008,0,0,0,0,2034,0,0,1019,1029,0,0,0,2009,0,1029,0,0,0,0,0,0,0,0,2013,0,3001,0,0,0,0,0,2012,0,0,1029,0
0,1021,2013,2013,2013,2013,2013,1021,0,2026,0,0,0,0,1021,1019,0,0,0,0,0,0,0,0,0,0,0,0,0,0,0,0,0,0,0,1019,1029,2035,0,0,2035,4007,1029,0,2033,0,0,0,0,0,0,2035,0,1029,0,0,0,0,0,0,0,0,1029,0
0,1021,0,0,0,0,0,1021,0,0,0,1021,1021,1021,1021,1019,0,0,0,0,0,0,0,0,0,0,0,0,0,0,0,0,0,0,0,1019,1029,1029,1029,1029,1029,1029,1029,0,0,0,0,0,0,0,0,0,0,1029,0,0,0,0,0,0,0,0,1029,0
0,1021,2035,2035,2035,2035,2035,1021,0,0,0,1021,1019,1019,1019,1019,1019,1019,1019,3002,1019,1019,1019,1019,1019,3002,1019,1019,1019,1019,1019,1019,3002,1019,1019,1019,1019,1019,1019,1029,1029,1029,1029,1029,1029,1029,1029,1029,1029,1029,1029,1029,1029,1029,1029,1029,1029,1029,1029,1029,1029,1029,1029,0
0,1021,4003,0,0,0,4007,1021,0,0,0,1021,1019,0,0,0,0,0,0,0,0,0,1019,0,0,0,0,0,1019,0,0,0,0,0,0,0,0,0,1019,1029,0,0,0,0,0,0,0,0,0,0,0,0,0,0,1029,0,0,0,0,0,0,4007,1029,0
0,1021,1021,1021,3002,1021,1021,1021,1021,3002,1001,1001,1019,0,0,0,0,0,0,0,0,0,1019,0,0,0,0,0,1019,0,0,0,0,0,0,0,0,0,1019,0,0,0,0,0,0,0,0,0,0,0,0,0,0,0,1029,0,0,0,0,0,0,4002,1029,0
0,1021,0,0,0,0,0,0,0,0,0,1021,1019,0,0,0,0,0,0,0,0,0,1019,0,0,0,0,0,1019,0,0,0,0,0,0,0,0,0,3001,0,0,2033,0,0,0,2031,0,0,0,0,0,2034,0,0,3001,0,0,0,2044,0,0,4002,1029,0
0,1021,0,0,0,0,0,0,0,0,0,1021,1019,0,2011,0,0,0,0,0,0,0,1019,0,0,0,0,0,1019,0,0,0,0,0,0,0,0,0,1019,0,0,0,0,0,0,0,0,0,0,0,0,0,0,0,1029,0,0,0,0,0,0,4002,1029,0
0,1021,0,0,0,0,0,0,0,0,0,1021,1019,0,0,0,0,0,0,0,0,0,1019,0,0,0,0,0,1019,0,0,0,2009,0,0,0,0,0,1019,1029,0,0,0,0,0,0,0,0,0,0,0,0,0,0,1029,0,0,0,0,0,0,4007,1029,0
0,1021,0,0,0,0,0,0,0,0,0,1021,1019,0,0,0,0,0,4002,0,4007,0,1019,0,0,0,0,0,1019,0,0,0,0,0,0,0,0,0,1019,1029,1029,1029,1029,1029,1029,1029,1029,1029,1029,1029,1029,1029,1029,1029,1029,1029,1029,1029,1029,1029,1029,1029,1029,0
0,1021,0,0,2025,0,4009,0,0,0,4007,1021,1019,1019,1019,1019,1019,1019,1019,1019,1019,1019,1019,0,0,0,0,0,1019,1019,1019,1019,1019,1019,1019,1019,1019,1019,1019,0,0,0,0,0,0,0,0,0,0,0,0,0,0,0,0,0,0,0,0,0,0,0,0,0
0,1021,0,0,0,0,0,0,0,0,4003,1021,1001,0,0,0,0,0,0,0,0,0,1019,0,0,0,0,0,1019,0,0,0,0,0,0,0,0,0,0,0,0,0,0,0,0,0,0,0,0,0,0,0,0,0,0,0,0,0,0,0,0,0,0,0
0,1021,1021,1021,1021,1021,1021,1021,1021,1021,1021,1021,1021,0,0,0,0,0,0,0,0,0,1019,0,0,4010,0,0,1019,0,0,0,0,0,0,0,0,0,0,0,0,0,0,0,0,0,0,0,0,0,0,0,0,0,0,0,0,0,0,0,0,0,0,0
0,0,0,0,0,0,0,0,0,0,0,0,0,0,0,0,0,0,0,0,0,0,1019,0,0,0,0,0,1019,0,0,0,0,0,0,0,0,0,0,0,0,0,0,0,0,0,0,0,0,0,0,0,0,0,0,0,0,0,0,0,0,0,0,0
0,0,0,0,0,0,0,0,0,0,0,0,0,0,0,0,0,0,0,0,0,0,1019,1019,1019,1019,1019,1019,1019,0,0,0,0,0,0,0,0,0,0,0,0,0,0,0,0,0,0,0,0,0,0,0,0,0,0,0,0,0,0,0,0,0,0,0

0,0,0,0,0,0,0,0,0,0,0,0,0,0,0,0,0,0,0,0,0,0,0,0,0,0,0,0,0,0,0,0,0,0,0,0,0,0,0,0,0,0,0,0,0,0,0,0,0,0,0,0,0,0,0,0,0,0,0,0,0,0,0,0
0,0,0,0,0,0,0,0,0,0,0,0,0,0,0,0,0,0,0,0,0,0,0,0,0,0,0,0,0,0,0,0,0,0,0,0,0,0,0,0,0,0,0,0,0,0,0,0,0,0,0,0,0,0,0,0,0,0,0,0,0,0,0,0
0,0,9027,9027,9027,9027,9027,0,9026,9026,9026,9026,9026,9026,9026,9026,9026,9026,9026,9026,9026,9026,9026,9026,9026,9026,9026,9026,9026,9026,9026,9026,9026,9026,9026,0,9024,9024,9024,0,9025,9025,9025,0,0,9019,9019,9019,9019,0,9020,9020,9020,9020,9020,9020,9020,0,9019,9019,9019,9019,0,0
0,0,9027,9027,9027,9027,9027,0,9026,9026,9026,9026,9026,9026,9026,9026,9026,9026,9026,9026,9026,9026,9026,9026,9026,9026,9026,9026,9026,9026,9026,9026,9026,9026,9026,0,9024,9024,9024,0,9025,9025,9025,0,0,9019,9019,9019,9019,0,9020,9020,9020,9020,9020,9020,9020,0,9019,9019,9019,9019,0,0
0,0,9027,9027,9027,9027,9027,0,9026,9026,9026,9026,9026,9026,9026,9026,9026,9026,9026,9026,9026,9026,9026,9026,9026,9026,9026,9026,9026,9026,9026,9026,9026,9026,9026,0,9024,9024,9024,0,9025,9025,9025,0,0,9019,9019,9019,9019,0,9020,9020,9020,9020,9020,9020,9020,0,9019,9019,9019,9019,0,0
0,0,9027,9027,9027,9027,9027,0,9026,9026,9026,9026,9026,9026,9026,9026,9026,9026,9026,9026,9026,9026,9026,9026,9026,9026,9026,9026,9026,9026,9026,9026,9026,9026,9026,0,9024,9024,9024,0,9025,9025,9025,0,0,9019,9019,9019,9019,0,9020,9020,9020,9020,9020,9020,9020,0,9019,9019,9019,9019,0,0
0,0,9027,9027,9027,9027,9027,0,9026,9026,9026,9026,9026,9026,9026,9026,9026,9026,9026,9026,9026,9026,9026,9026,9026,9026,9026,9026,9026,9026,9026,9026,9026,9026,9026,0,9024,9024,9024,0,9025,9025,9025,0,0,9019,9019,9019,9019,0,9020,9020,9020,9020,9020,9020,9020,0,9019,9019,9019,9019,0,0
0,0,9027,9027,9027,9027,9027,0,9026,9026,9026,9026,9026,9026,9026,9026,9026,9026,9026,9026,9026,9026,9026,9026,9026,9026,9026,9026,9026,9026,9026,9026,9026,9026,9026,0,9024,9024,9024,0,9025,9025,9025,0,0,9019,9019,9019,9019,0,9020,9020,9020,9020,9020,9020,9020,0,9019,9019,9019,9019,0,0
0,0,0,0,0,0,0,0,0,0,0,0,0,0,0,0,0,0,0,0,0,0,0,0,0,0,0,0,0,0,0,0,0,0,0,0,9024,9024,9024,0,0,0,0,0,0,9019,9019,9019,9019,0,0,0,0,0,0,0,0,0,9019,9019,9019,9019,0,0
0,0,9028,9028,9028,9028,9028,0,9032,9032,9032,9032,9032,9032,9032,9032,9032,9032,9032,9032,9032,9032,9032,9032,9032,9032,9032,9032,9032,9032,9032,9032,9032,9032,9032,0,9024,9024,9024,9024,9024,9024,9024,0,0,9019,9019,9019,9019,9019,9019,9019,9019,9019,9019,9019,9019,9019,9019,9019,9019,9019,0,0
0,0,9028,9028,9028,9028,9028,0,9032,9032,0,0,0,0,0,0,9032,9032,0,0,0,0,0,0,9032,9032,0,0,0,0,0,0,9032,9032,9032,0,9024,9024,9024,9024,9024,9024,9024,0,0,9019,9019,9019,9019,9019,9019,9019,9019,9019,9019,9019,9019,9019,9019,9019,9019,9019,0,0
0,0,9028,9028,9028,9028,9028,0,9032,9032,0,9033,9033,9033,9033,0,9032,9032,0,9034,9034,9034,9034,0,9032,9032,0,9035,9035,9035,9035,0,9032,9032,9032,0,9024,9024,9024,9024,9024,9024,9024,0,0,9019,9019,9019,9019,9019,9019,9019,9019,9019,9019,9019,9019,9019,9019,9019,9019,9019,9019,0
0,0,9028,9028,9028,9028,9028,0,9032,9032,0,9033,9033,9033,9033,0,9032,9032,0,9034,9034,9034,9034,0,9032,9032,0,9035,9035,9035,9035,0,9032,9032,9032,0,9024,9024,9024,9024,9024,9024,9024,0,0,9019,9019,9019,9019,9019,9019,9019,9019,9019,9019,9019,9019,9019,9019,9019,9019,9019,9019,0
0,0,9028,9028,9028,9028,9028,0,9032,9032,0,9033,9033,9033,9033,0,9032,9032,0,9034,9034,9034,9034,0,9032,9032,0,9035,9035,9035,9035,0,9032,9032,9032,0,9024,9024,9024,9024,9024,9024,9024,0,0,9019,9019,9019,9019,9019,9019,9019,9019,9019,9019,9019,9019,9019,9019,9019,9019,9019,0,0
0,0,9028,9028,9028,9028,9028,0,9032,9032,0,9033,9033,9033,9033,0,9032,9032,0,9034,9034,9034,9034,0,9032,9032,0,9035,9035,9035,9035,0,9032,9032,9032,0,9024,9024,9024,9024,9024,9024,9024,0,0,9019,9019,9019,9019,9019,9019,9019,9019,9019,9019,9019,9019,9019,9019,9019,9019,9019,0,0
0,0,9028,9028,9028,9028,9028,0,9032,9032,0,0,0,0,0,0,9032,9032,0,0,0,0,0,0,9032,9032,0,0,0,0,0,0,9032,9032,9032,0,9024,9024,9024,9024,9024,9024,9024,0,0,9019,9019,9019,9019,9019,9019,9019,9019,9019,9019,9019,9019,9019,9019,9019,9019,9019,9019,0
0,0,9028,9028,9028,9028,9028,0,9032,9032,9032,9032,9032,9032,9032,9032,9032,9032,9032,9032,9032,9032,9032,9032,9032,9032,9032,9032,9032,9032,9032,9032,9032,9032,9032,0,0,0,0,0,0,0,0,0,0,0,0,0,0,0,0,0,0,0,0,0,0,0,9019,0,0,0,0,0
0,0,9028,9028,9028,9028,9028,0,9032,9032,9032,9032,9032,9032,9032,9032,9032,9032,9032,9032,9032,9032,9032,9032,9032,9032,9032,9032,9032,9032,9032,9032,9032,9032,9032,0,9023,9023,9023,9023,9023,9023,9023,0,0,9017,9017,9017,9017,9017,0,9018,9018,9018,9018,9018,9018,9018,9018,9018,9018,9018,0,0
0,0,9028,9028,9028,9028,9028,0,9032,9032,9032,9032,9032,9032,9032,9032,9032,9032,9032,9032,9032,9032,9032,9032,9032,9032,9032,9032,9032,9032,9032,9032,9032,9032,9032,0,9023,9023,9023,9023,9023,9023,9023,0,0,9017,9017,9017,9017,9017,0,9018,9018,9018,9018,9018,9018,9018,9018,9018,9018,9018,0,0
0,0,9028,9028,9028,9028,9028,0,9032,9032,9032,9032,9032,9032,9032,9032,9032,9032,9032,9032,9032,9032,9032,9032,9032,9032,9032,9032,9032,9032,9032,9032,9032,9032,9032,0,9023,9023,9023,9023,9023,9023,9023,0,0,9017,9017,9017,9017,9017,0,9018,9018,9018,9018,9018,9018,9018,9018,9018,9018,9018,0,0
0,0,9028,9028,9028,9028,9028,0,9032,9032,9032,9032,9032,9032,9032,9032,9032,9032,9032,9032,9032,9032,9032,9032,9032,9032,9032,9032,9032,9032,9032,9032,9032,9032,9032,0,9023,9023,9023,9023,9023,9023,9023,0,0,9017,9017,9017,9017,9017,0,9018,9018,9018,9018,9018,9018,9018,9018,9018,9018,0,0,0
0,0,9028,9028,9028,9028,9028,0,9032,9032,9032,9032,9032,9032,9032,9032,9032,9032,9032,9032,9032,9032,9032,9032,9032,9032,9032,9032,9032,9032,9032,9032,9032,9032,9032,0,9023,9023,9023,9023,9023,9023,9023,0,0,0,0,0,0,0,0,9018,9018,9018,9018,9018,9018,9018,9018,9018,9018,9018,0,0
0,0,9028,9028,9028,9028,9028,0,9032,9032,9032,9032,9032,9032,9032,9032,9032,9032,9032,9032,9032,9032,9032,9032,9032,9032,9032,9032,9032,9032,9032,9032,9032,9032,9032,0,9023,9023,9023,9023,9023,9023,9023,0,0,9016,9016,9016,9016,9016,0,9018,9018,9018,9018,9018,9018,9018,9018,9018,9018,0,0,0
0,0,9028,9028,9028,9028,9028,0,9032,9032,9032,9032,9032,9032,9032,9032,9032,9032,9032,9032,9032,9032,9032,9032,9032,9032,9032,9032,9032,9032,9032,9032,9032,9032,9032,0,9023,9023,9023,9023,9023,9023,9023,0,0,9016,9016,9016,9016,9016,0,9018,9018,9018,9018,9018,9018,9018,9018,9018,9018,9018,0,0
0,0,9028,9028,9028,9028,9028,0,0,0,0,0,0,0,0,0,0,0,0,0,0,0,0,0,0,0,0,0,0,0,0,9032,9032,9032,9032,0,9023,9023,9023,9023,9023,9023,9023,0,0,9016,9016,9016,9016,9016,0,9018,9018,9018,9018,9018,9018,9018,9018,9018,9018,0,0,0
0,0,9028,9028,9028,9028,9028,0,9031,9031,9031,9031,9031,9031,0,0,9036,9036,9036,9036,0,9021,9021,9021,9021,9021,9021,9021,9021,9021,0,0,9032,9032,9032,0,9023,9023,9023,9023,9023,9023,9023,0,0,9016,9016,9016,9016,9016,0,9018,9018,9018,9018,9018,9018,9018,9018,9018,9018,0,0,0
0,0,9028,9028,9028,9028,9028,0,9031,9031,9031,9031,9031,9031,0,0,9036,9036,9036,9036,0,9021,9021,9021,9021,9021,9021,9021,9021,9021,0,0,0,0,0,0,0,0,0,0,0,0,0,0,0,9016,9016,9016,9016,9016,0,9018,9018,9018,9018,9018,9018,9018,9018,9018,9018,9018,0,0
0,0,9028,9028,9028,9028,9028,0,9031,9031,9031,9031,9031,9031,0,0,9036,9036,9036,9036,0,9021,9021,9021,9021,0,0,0,0,9021,0,9022,9022,9022,9022,9022,9022,9022,9022,9022,9022,9022,9022,0,0,9016,9016,9016,9016,9016,0,9018,9018,9018,9018,9018,9018,9018,9018,9018,9018,9018,0,0
0,0,9028,9028,9028,9028,9028,0,9031,9031,9031,9031,9031,9031,0,0,9036,9036,9036,9036,0,9021,9021,0,9021,9021,9021,9021,9021,9021,0,0,9022,9022,9022,9022,9022,9022,9022,9022,9022,9022,9022,0,0,9016,9016,9016,9016,9016,0,9018,9018,9018,9018,9018,9018,9018,9018,9018,0,9018,0,0
0,0,9028,9028,9028,9028,9028,0,9031,9031,9031,9031,9031,9031,0,0,9036,9036,9036,9036,0,9021,0,9021,9021,9021,9021,9021,9021,9021,0,9022,9022,9022,9022,0,9022,9022,9022,9022,9022,9022,9022,0,0,0,0,0,0,0,0,0,0,0,0,0,0,0,0,0,0,0,0,0
0,0,9028,9028,9028,9028,9028,0,9031,9031,9031,9031,9031,9031,0,0,9036,9036,9036,9036,0,0,9021,9021,9021,9021,9021,9021,9021,9021,0,9022,9022,9022,9022,9022,9022,9022,9022,9022,9022,9022,9022,0,0,9015,9015,9015,9015,9015,9015,9015,9015,9015,9015,9015,9015,9015,9015,9015,9015,9015,0,0
0,0,9028,9028,9028,9028,9028,0,9031,9031,9031,9031,9031,9031,0,0,0,0,0,0,0,0,0,9021,9021,9021,9021,9021,0,0,0,0,0,0,0,0,0,9022,9022,9022,9022,9022,9022,0,0,9015,9015,9015,9015,9015,9015,9015,9015,9015,9015,9015,9015,9015,9015,9015,9015,9015,0,0
0,0,9028,9028,9028,9028,9028,0,9031,9031,9031,9031,9031,9031,0,0,0,0,0,0,0,0,0,0,0,0,0,0,0,0,0,0,0,0,0,0,0,9022,9022,9022,9022,9022,9022,0,0,9015,9015,9015,9015,9015,9015,9015,9015,9015,9015,9015,9015,9015,9015,9015,9015,9015,0,0
0,0,9028,9028,9028,9028,9028,0,9031,9031,9031,9031,9031,9031,0,0,9002,9002,9002,9002,9002,9002,9002,9002,9002,9002,9002,9002,9002,9002,9002,9002,9002,9002,9002,0,0,9022,9022,9022,9022,9022,9022,0,0,9015,9015,9015,9015,9015,9015,9015,9015,9015,9015,9015,9015,9015,9015,9015,9015,9015,0,0
0,0,9028,9028,9028,9028,9028,0,9031,9031,9031,9031,9031,9031,0,0,9002,9002,9002,9002,9002,9002,9002,9002,9002,9002,9002,9002,9002,9002,9002,9002,9002,9002,9002,0,0,9022,9022,9022,9022,9022,9022,0,0,9015,9015,9015,9015,9015,9015,9015,9015,9015,9015,9015,9015,9015,9015,9015,9015,9015,0,0
0,0,9028,9028,9028,9028,9028,0,9031,9031,9031,9031,9031,9031,0,0,9002,9002,9002,9002,9002,9002,9002,9002,9002,9002,9002,9002,9002,9002,9002,9002,9002,9002,9002,0,0,9022,9022,9022,9022,9022,9022,0,0,9015,9015,9015,9015,9015,9015,9015,9015,9015,9015,9015,9015,9015,9015,9015,9015,9015,0,0
0,0,9028,9028,9028,9028,9028,0,9031,9031,9031,9031,9031,9031,0,0,9002,9002,9002,9002,9002,9002,9002,9002,9002,9002,9002,9002,9002,9002,9002,9002,9002,9002,9002,0,0,0,0,0,0,0,0,0,0,0,0,0,0,0,0,0,0,0,0,0,9015,9015,9015,9015,9015,0,0,0
0,0,9028,9028,9028,9028,9028,0,9031,9031,9031,9031,9031,9031,0,0,9002,9002,9002,9002,9002,0,0,0,0,0,0,0,0,0,9002,9002,9002,9002,9002,0,0,0,0,0,0,0,0,0,0,0,0,0,0,0,0,0,0,0,0,0,0,0,0,0,0,0,0,0
0,0,9028,9028,9028,9028,9028,0,9031,9031,9031,9031,9031,9031,0,0,9002,9002,9002,9002,9002,0,9003,9003,0,0,0,9003,9003,0,9002,9002,9002,9002,9002,0,9006,9006,9006,9006,9006,9006,0,9011,9011,9011,9011,0,9012,9012,9012,9012,9012,0,9014,9014,9014,9014,9014,9014,9014,9014,0,0
0,0,9028,9028,9028,9028,9028,0,9031,9031,9031,9031,9031,9031,0,0,9002,9002,9002,9002,9002,0,9003,9003,0,0,0,9003,9003,0,9002,9002,9002,9002,9002,0,9006,9006,9006,9006,9006,9006,0,9011,9011,9011,9011,0,9012,9012,9012,9012,9012,0,9014,9014,9014,9014,9014,9014,9014,9014,0,0
0,0,9028,9028,9028,9028,9028,0,9031,9031,9031,9031,9031,9031,0,0,9002,9002,9002,9002,9002,0,9003,9003,0,0,0,9003,9003,0,9002,9002,9002,9002,9002,0,9006,9006,9006,9006,9006,9006,0,9011,9011,9011,9011,0,9012,9012,9012,9012,9012,0,9014,9014,9014,9014,9014,9014,9014,9014,0,0
0,0,9028,9028,9028,9028,9028,0,9031,9031,9031,9031,9031,9031,0,0,9002,9002,9002,9002,9002,0,9003,9003,9003,9003,9003,9003,9003,0,9002,9002,9002,9002,9002,0,9006,9006,9006,9006,9006,9006,0,9011,9011,9011,9011,0,9012,9012,9012,9012,9012,0,9014,9014,9014,9014,9014,9014,9014,9014,0,0
0,0,9028,9028,9028,9028,9028,0,9031,9031,9031,9031,9031,9031,0,0,9002,9002,9002,9002,9002,0,9003,9003,9003,9003,9003,9003,9003,0,9002,9002,9002,9002,9002,0,9006,9006,9006,9006,9006,9006,0,9011,9011,9011,9011,0,0,0,0,0,0,0,9014,9014,9014,9014,9014,9014,9014,9014,0,0
0,0,9028,9028,9028,9028,9028,0,9031,9031,9031,9031,9031,9031,0,0,9002,9002,9002,9002,9002,0,0,0,9003,9003,9003,0,0,0,9002,9002,9002,9002,9002,0,9006,9006,9006,9006,9006,9006,0,9011,9011,9011,9011,9011,9011,9011,9011,9011,9011,0,9014,9014,9014,9014,9014,9014,9014,9014,0,0
0,0,9028,9028,9028,9028,9028,0,9031,9031,9031,9031,9031,9031,0,0,9002,9002,9002,9002,9002,0,9005,0,9003,9003,9003,0,9004,0,9002,9002,9002,9002,9002,0,9006,9006,9006,9006,9006,9006,0,9011,9011,9011,9011,9011,9011,9011,9011,9011,9011,0,9014,9014,9014,9014,9014,9014,9014,9014,0,0
0,0,9028,9028,9028,9028,9028,0,9031,9031,9031,9031,9031,9031,0,0,9002,9002,9002,9002,9002,0,9005,0,9003,9003,9003,0,9004,0,9002,9002,9002,9002,9002,0,9006,9006,9006,9006,9006,9006,0,9011,9011,9011,9011,9011,9011,9011,9011,9011,9011,0,0,0,0,0,0,0,0,0,0,0
0,0,9028,9028,9028,9028,9028,0,9031,9031,9031,9031,9031,9031,0,0,9002,9002,9002,9002,9002,0,0,0,0,0,0,0,0,0,9002,9002,9002,9002,9002,0,9006,9006,9006,9006,9006,9006,0,9011,9011,9011,9011,9011,9011,9011,9011,9011,9011,0,9013,9013,9013,9013,9013,9013,9013,9013,0,0
0,0,9028,9028,9028,9028,9028,0,0,0,9028,0,0,0,0,0,9002,9002,9002,9002,9002,9002,9002,9002,9002,9002,9002,9002,9002,9002,9002,9002,9002,9002,9002,0,9006,9006,9006,9006,9006,9006,0,9011,9011,9011,9011,9011,9011,9011,9011,9011,9011,0,9013,9013,9013,9013,9013,9013,9013,9013,0,0
0,0,9028,9028,9028,9028,9028,0,9030,9030,9030,9030,9030,9030,0,0,9002,9002,9002,9002,9002,9002,9002,9002,9002,9002,9002,9002,9002,9002,9002,9002,9002,9002,9002,0,9006,9006,9006,9006,9006,9006,0,9011,9011,9011,9011,9011,9011,9011,9011,9011,9011,0,9013,9013,9013,9013,9013,9013,9013,9013,0,0
0,0,9028,9028,9028,9028,9028,0,9030,9030,9030,9030,9030,9030,0,0,9002,9002,9002,9002,9002,9002,9002,9002,9002,9002,9002,9002,9002,9002,9002,9002,9002,9002,9002,0,9006,9006,9006,9006,9006,9006,0,9011,9011,9011,9011,9011,9011,9011,9011,9011,9011,0,9013,9013,9013,9013,9013,9013,9013,9013,0,0
0,0,9028,9028,9028,9028,9028,0,9030,9030,9030,9030,9030,9030,0,0,9002,9002,9002,9002,9002,9002,9002,9002,9002,9002,9002,9002,9002,9002,9002,9002,9002,9002,9002,0,9006,9006,9006,9006,9006,9006,0,9011,9011,9011,9011,9011,9011,9011,9011,9011,9011,0,9013,9013,9013,9013,9013,9013,9013,9013,0,0
0,0,9028,9028,9028,9028,9028,9028,9030,9030,9030,0,0,0,0,0,9002,9002,9002,9002,9002,9002,9002,9002,9002,9002,9002,9002,9002,9002,9002,9002,9002,9002,9002,0,9006,9006,9006,9006,9006,9006,0,9011,9011,9011,9011,9011,9011,9011,9011,9011,9011,0,9013,9013,9013,9013,9013,9013,9013,9013,0,0
0,0,9028,9028,9028,9028,9028,0,9030,9030,9030,0,0,0,0,0,0,0,0,0,0,0,0,0,0,0,0,0,0,0,0,0,0,0,0,0,0,0,0,0,0,0,0,0,0,0,0,0,0,0,0,0,0,0,0,0,0,0,0,0,0,0,0,0
0,0,9028,9028,9028,9028,9028,0,9030,9030,9030,0,0,9007,9007,9007,9007,9007,9007,9007,9007,9007,0,9001,9001,9001,9001,9001,0,9008,9008,9008,9008,9008,9008,9008,9008,9008,0,9009,9009,9009,9009,9009,9009,9009,9009,9009,9009,9009,9009,9009,9009,9009,0,9010,9010,9010,9010,9010,9010,9010,0,0
0,0,0,0,0,0,0,0,0,0,0,0,0,9007,9007,9007,9007,9007,9007,9007,9007,9007,0,9001,9001,9001,9001,9001,0,9008,9008,9008,9008,9008,9008,9008,9008,9008,0,9009,9009,9009,9009,9009,9009,9009,9009,9009,9009,9009,9009,9009,9009,9009,0,9010,9010,9010,9010,9010,9010,9010,0,0
0,0,9029,9029,9029,9029,9029,9029,9029,9029,9029,0,0,9007,9007,9007,9007,9007,9007,9007,9007,9007,0,9001,9001,9001,9001,9001,0,9008,9008,9008,9008,9008,9008,9008,9008,9008,0,9009,9009,9009,9009,9009,9009,9009,9009,9009,9009,9009,9009,9009,9009,9009,0,9010,9010,9010,9010,9010,9010,9010,0,0
0,0,9029,9029,9029,9029,9029,9029,9029,9029,9029,0,0,9007,9007,9007,9007,9007,9007,9007,9007,9007,0,9001,9001,9001,9001,9001,0,9008,9008,9008,9008,9008,9008,9008,9008,9008,0,9009,9009,9009,9009,9009,9009,9009,9009,9009,9009,9009,9009,9009,9009,9009,0,9010,9010,9010,9010,9010,9010,9010,0,0
0,0,9029,9029,9029,9029,9029,9029,9029,9029,9029,0,0,9007,9007,9007,9007,9007,9007,9007,9007,9007,0,9001,9001,9001,9001,9001,0,9008,9008,9008,9008,9008,9008,9008,9008,9008,0,9009,9009,9009,9009,9009,9009,9009,9009,9009,9009,9009,9009,9009,9009,9009,0,9010,9010,9010,9010,9010,9010,9010,0,0
0,0,9029,9029,9029,9029,9029,9029,9029,9029,9029,0,0,9007,9007,9007,9007,9007,9007,9007,9007,9007,0,9001,9001,9001,9001,9001,0,9008,9008,9008,9008,9008,9008,9008,9008,9008,0,0,0,0,0,0,0,0,0,0,0,0,0,0,0,0,0,0,0,0,0,0,0,0,0,0
0,0,9029,9029,9029,9029,9029,9029,9029,9029,9029,0,0,0,0,0,0,0,0,0,0,0,0,9001,9001,9001,9001,9001,0,0,0,0,0,0,0,0,0,0,0,0,0,0,0,0,0,0,0,0,0,0,0,0,0,0,0,0,0,0,0,0,0,0,0,0
0,0,9029,9029,9029,9029,9029,9029,9029,9029,9029,0,0,0,0,0,0,0,0,0,0,0,0,9001,9001,9001,9001,9001,0,0,0,0,0,0,0,0,0,0,0,0,0,0,0,0,0,0,0,0,0,0,0,0,0,0,0,0,0,0,0,0,0,0,0,0
0,0,0,0,0,0,0,0,0,0,0,0,0,0,0,0,0,0,0,0,0,0,0,9001,9001,9001,9001,9001,0,0,0,0,0,0,0,0,0,0,0,0,0,0,0,0,0,0,0,0,0,0,0,0,0,0,0,0,0,0,0,0,0,0,0,0
0,0,0,0,0,0,0,0,0,0,0,0,0,0,0,0,0,0,0,0,0,0,0,9001,9001,9001,9001,9001,0,0,0,0,0,0,0,0,0,0,0,0,0,0,0,0,0,0,0,0,0,0,0,0,0,0,0,0,0,0,0,0,0,0,0,0
0,0,0,0,0,0,0,0,0,0,0,0,0,0,0,0,0,0,0,0,0,0,0,0,0,0,0,0,0,0,0,0,0,0,0,0,0,0,0,0,0,0,0,0,0,0,0,0,0,0,0,0,0,0,0,0,0,0,0,0,0,0,0,0
