64
1040
1044
0,0,0,0,0,0,0,0,0,0,0,0,0,0,0,0,0,0,0,0,0,0,0,0,0,0,0,0,0,0,0,0,0,0,0,0,0,0,0,0,0,0,0,0,0,0,0,0,0,0,0,0,0,0,0,0,0,0,0,0,0,0,0,0
0,0,0,0,0,0,0,0,0,0,0,0,0,0,0,0,0,0,0,0,0,0,0,0,0,0,0,0,0,0,0,0,0,0,0,0,0,0,0,0,0,0,0,0,0,0,0,0,0,0,0,0,0,0,0,0,0,0,0,0,0,0,0,0
0,0,0,0,0,0,0,0,0,0,0,0,0,0,0,0,0,0,0,0,0,0,0,0,1029,1029,1029,1029,1029,1029,1029,1029,1029,0,0,0,0,0,0,0,0,0,0,0,0,0,0,0,0,0,0,0,0,0,0,0,0,0,0,0,0,0,0,0
0,0,0,0,0,0,0,0,0,0,0,0,0,0,0,0,0,0,0,0,0,0,0,0,1029,0,0,0,0,0,0,0,1029,0,0,0,0,0,0,0,0,0,0,0,0,1030,1030,1030,1030,1030,1030,1030,0,0,0,0,0,0,0,0,0,0,0,0
0,0,0,0,0,0,0,0,0,0,0,0,0,0,0,0,0,0,0,0,0,0,0,0,1029,0,0,0,0,0,0,0,1029,1030,1030,1030,1030,1030,1030,1030,1030,1030,1030,1030,1030,1030,0,0,0,0,0,1030,0,0,0,0,0,0,0,0,0,0,0,0
0,0,0,0,0,0,0,0,0,0,0,0,0,0,0,0,0,0,0,0,0,0,0,0,1029,0,0,0,0,0,0,0,1029,0,0,0,0,0,0,0,0,0,0,0,2028,1030,0,1012,1012,1012,0,1030,0,0,0,0,0,0,0,0,0,0,0,0
0,0,0,0,0,0,0,0,0,0,0,0,0,0,0,0,0,0,0,0,0,0,0,0,1029,0,0,0,0,0,0,0,3001,0,0,0,0,0,0,0,0,0,0,0,0,3003,0,3001,4011,1012,0,1030,0,0,0,0,0,0,0,0,0,0,0,0
0,0,0,0,0,0,0,0,0,0,0,0,0,0,0,0,0,0,0,0,0,0,0,0,1029,0,0,0,0,0,0,0,1029,0,0,0,0,0,0,0,0,0,0,0,2028,1030,0,1012,1012,1012,0,1030,0,0,0,0,0,0,0,0,0,0,0,0
0,0,0,0,0,0,0,0,0,0,0,0,0,0,0,0,0,0,0,0,0,0,0,0,1029,0,0,0,0,0,0,0,1029,1030,1030,1030,1030,1030,1030,1030,1030,1030,1030,1030,1030,1030,0,0,0,0,0,1030,0,0,0,0,0,0,0,0,0,0,0,0
0,0,0,0,0,0,0,0,0,0,0,0,0,0,0,0,0,0,0,0,0,0,0,0,1029,0,0,0,0,0,0,0,1029,0,0,0,0,0,0,0,0,0,0,0,0,1030,1030,1030,1030,1030,1030,1030,0,0,0,0,0,0,0,0,0,0,0,0
0,0,0,0,0,0,0,0,0,0,0,0,0,0,0,0,0,0,0,0,0,0,0,0,1029,0,0,0,0,0,0,0,1029,0,0,0,0,0,0,0,0,0,0,0,0,0,0,0,0,0,0,0,0,0,0,0,0,0,0,0,0,0,0,0
0,0,0,0,0,0,0,0,0,0,0,0,0,0,0,0,0,0,0,0,0,0,0,0,1029,0,0,0,0,0,0,0,1029,0,0,0,0,0,0,0,0,0,0,0,0,0,0,0,0,0,0,0,0,0,0,0,0,0,0,0,0,0,0,0
0,0,0,0,0,0,0,0,0,0,0,1029,1029,1029,1029,1029,1029,1029,1029,1029,1029,1029,1029,1029,1029,1029,1029,1029,3002,1029,1029,1029,1029,1029,1029,1029,1029,1029,1029,1029,1029,1029,1029,1029,1029,0,0,0,0,0,0,0,0,0,0,0,0,0,0,0,0,0,0,0
0,0,0,0,0,0,0,0,0,0,0,1029,0,0,0,0,0,0,0,0,0,0,0,0,0,0,2026,0,0,0,2026,0,0,0,0,0,0,0,0,0,0,0,0,0,1029,0,0,0,0,0,0,0,0,0,0,0,0,0,0,0,0,0,0,0
0,0,0,0,0,0,0,0,0,0,0,1029,0,0,0,0,0,0,0,0,0,0,0,0,0,0,0,0,0,0,0,0,0,0,0,0,0,0,0,0,0,0,0,0,1029,0,0,0,0,0,0,0,0,0,0,0,0,0,0,0,0,0,0,0
0,0,0,0,0,0,0,0,0,0,0,1029,0,0,0,0,0,0,0,0,0,0,0,0,0,0,0,0,0,0,0,0,0,0,0,0,0,0,0,0,0,0,0,0,1029,0,0,0,0,0,0,0,0,0,0,0,0,0,0,0,0,0,0,0
0,0,0,0,0,0,0,0,0,0,0,1029,0,0,0,0,0,0,0,0,0,0,0,0,0,0,0,0,0,0,0,0,0,0,0,0,0,0,0,0,0,0,0,0,1029,0,0,0,0,0,0,0,0,0,0,0,0,0,0,0,0,0,0,0
0,0,0,0,0,0,0,0,0,0,0,1029,0,0,0,0,1029,1029,1029,3002,1029,1029,1029,1029,0,0,0,0,0,0,0,0,0,1029,1029,1029,1029,1029,1029,1029,1029,0,0,0,1029,0,0,0,0,0,0,0,0,0,0,0,0,0,0,0,0,0,0,0
0,0,0,0,0,0,0,0,0,0,0,1029,0,0,0,0,1029,1029,1029,0,1029,1029,1029,1029,0,0,0,0,0,0,0,0,0,1029,1029,1029,1029,1029,1029,1029,1029,0,0,0,1029,0,0,0,0,0,0,0,0,0,0,0,0,0,0,0,0,0,0,0
0,0,0,0,0,0,0,0,0,0,0,1029,0,0,0,0,1029,1029,1029,0,1029,1029,1029,1029,0,0,0,0,0,0,0,0,0,1029,1029,1029,1029,1029,1029,1029,1029,0,0,0,1029,0,0,0,0,0,0,0,0,0,0,0,0,0,0,0,0,0,0,0
0,1030,1030,1030,1030,1030,1030,1030,1030,1030,1030,1029,0,0,0,0,1029,1029,1029,0,0,0,1029,1029,0,0,0,0,0,0,0,0,0,1029,1029,1029,1029,1029,1029,1029,1029,0,0,0,1029,1030,1030,1030,1030,1030,1030,1030,1030,1030,1030,0,0,0,0,0,0,0,0,0
0,1030,0,0,0,0,0,0,0,0,1030,1029,0,0,0,0,1029,1029,1029,0,4009,0,1029,1029,0,0,0,0,0,0,0,0,0,1029,1029,1029,1029,1029,1029,1029,1029,0,0,0,1029,1030,0,0,0,0,0,0,0,0,1030,0,0,0,0,0,0,0,0,0
0,1030,0,0,0,0,0,0,0,0,1030,1029,0,0,0,0,1029,1029,1029,0,0,0,1029,1029,0,0,0,0,0,0,0,0,0,1029,1029,1029,1029,1029,1029,1029,1029,0,0,0,1029,1030,0,0,0,0,0,0,0,0,1030,0,0,0,0,0,0,0,0,0
0,1030,0,0,0,0,0,0,0,0,0,1029,0,0,0,0,1029,1029,1029,1029,1029,1029,1029,1029,0,0,0,0,0,0,0,0,0,1029,1029,1029,1029,1029,1029,1029,1029,0,0,0,1029,0,0,0,0,0,0,0,0,0,1030,0,0,0,0,0,0,0,0,0
0,1030,0,0,0,0,0,0,0,0,0,1029,0,0,0,0,1029,1029,1029,1029,1029,1029,1029,1029,0,0,0,0,0,0,0,0,0,1029,1029,1029,1029,1029,1029,1029,1029,0,0,0,1029,0,0,0,0,0,0,0,0,0,1030,0,0,0,0,0,0,0,0,0
0,1030,0,0,0,0,0,0,0,0,0,3005,0,0,0,0,0,0,0,0,0,0,0,0,0,0,0,0,0,0,0,0,0,0,0,0,0,0,0,0,0,0,0,0,3005,0,0,0,0,0,0,0,0,0,1030,0,0,0,0,0,0,0,0,0
0,1030,0,0,0,0,0,0,0,0,0,1029,0,0,0,0,0,0,0,0,0,0,0,0,0,0,0,0,0,0,0,0,0,0,0,0,0,0,0,0,0,0,0,0,1029,0,0,0,0,0,0,0,0,0,1030,0,0,0,0,0,0,0,0,0
0,1030,0,0,0,0,0,0,0,0,0,1029,0,0,0,0,1029,1029,1029,1029,1029,1029,1029,1029,0,0,0,0,0,0,0,0,0,1029,1029,1029,1029,1029,1029,1029,1029,0,0,0,1029,0,0,0,0,0,0,0,0,0,1030,0,0,0,0,0,0,0,0,0
0,1030,0,0,0,0,0,0,0,0,1030,1029,0,0,0,0,1029,1029,1029,1029,1029,1029,1029,1029,0,0,0,0,0,0,0,0,0,1029,1029,1029,1029,1029,1029,1029,1029,0,0,0,1029,1030,0,0,0,0,0,0,0,0,1030,0,0,0,0,0,0,0,0,0
0,1030,0,0,0,0,0,0,0,0,1030,1029,0,0,0,0,1029,1029,1029,1029,1029,1029,1029,1029,0,0,0,0,0,0,0,0,0,1029,1029,1029,1029,1029,1029,1029,1029,0,0,0,1029,1030,4003,4003,4003,4003,4003,4003,4003,0,1030,0,0,0,0,0,0,0,0,0
0,1030,0,4007,4007,4007,4007,4007,4007,4007,1030,1029,0,0,0,0,1029,1029,1029,1029,1029,1029,1029,1029,0,0,0,0,0,0,0,0,0,1029,1029,1029,1029,1029,1029,1029,1029,0,0,0,1029,1030,4003,4003,4003,4003,4003,4003,4003,0,1030,0,0,0,0,0,0,0,0,0
0,1030,0,4007,4007,4007,4007,4007,4007,4007,1030,1029,0,0,0,0,1029,1029,1029,1029,1029,1029,1029,1029,0,0,0,0,0,0,0,0,0,1029,1029,1029,1029,1029,1029,1029,1029,0,0,0,1029,1030,4003,4003,4003,4003,4003,4003,4003,0,1030,0,0,0,0,0,0,0,0,0
0,1030,0,4007,4007,4007,4007,4007,4007,4007,1030,1029,0,0,0,0,1029,1029,1029,1029,1029,1029,1029,1029,0,0,0,0,0,0,0,0,0,1029,1029,1029,1029,1029,1029,1029,1029,0,0,0,1029,1030,4003,4003,4003,4003,4003,4003,4003,0,1030,0,0,0,0,0,0,0,0,0
0,1030,0,4007,4007,4007,4007,4007,4007,4007,1030,1029,0,0,0,0,1029,1029,1029,1029,1029,1029,1029,1029,0,0,0,0,0,0,0,0,0,1029,1029,1029,1029,1029,1029,1029,1029,0,0,0,1029,1030,4003,4003,4003,4003,4003,4003,4003,0,1030,0,0,0,0,0,0,0,0,0
0,1030,0,4007,4007,4007,4007,4007,4007,4007,1030,1029,0,0,0,0,1029,1029,1029,1029,1029,1029,1029,1029,0,0,0,0,0,0,0,0,0,1029,1029,1029,1029,1029,1029,1029,1029,0,0,0,1029,1030,4003,4003,4003,4003,4003,4003,4003,0,1030,0,0,0,0,0,0,0,0,0
0,1030,0,4007,4007,4007,4007,4007,4007,4007,1030,1029,0,0,0,0,0,0,0,0,0,0,0,0,0,0,0,0,0,0,0,0,0,0,0,0,0,0,0,0,0,0,0,0,1029,1030,4003,4003,4003,4003,4003,4003,4003,0,1030,0,0,0,0,0,0,0,0,0
0,1030,0,4007,4007,4007,4007,4007,4007,4007,1030,1029,0,0,0,0,0,0,0,0,0,0,0,0,0,0,0,0,0,0,0,0,0,0,0,0,0,0,0,0,0,0,0,0,1029,1030,4003,4003,4003,4003,4003,4003,4003,0,1030,0,0,0,0,0,0,0,0,0
0,1030,0,4007,4007,4007,4007,4007,4007,4007,1030,1029,0,0,0,0,1029,1029,1029,1029,1029,1029,1029,1029,0,0,0,0,0,0,0,0,0,1029,1029,1029,1029,1029,1029,1029,1029,0,0,0,1029,1030,4003,4003,4003,4003,4003,4003,4003,0,1030,0,0,0,0,0,0,0,0,0
0,1030,0,4007,4007,4007,4007,4007,4007,4007,1030,1029,0,0,0,0,1029,1029,1029,0,0,0,0,1029,0,0,0,0,0,0,0,0,0,1029,1029,1029,1029,1029,1029,1029,1029,0,0,0,1029,1030,0,0,0,0,0,0,0,0,1030,0,0,0,0,0,0,0,0,0
0,1030,0,0,0,0,0,0,0,0,1030,1029,0,0,0,0,1029,1029,1029,0,0,4009,0,1029,0,0,0,0,0,0,0,0,0,1029,1029,1029,1029,1029,1029,1029,1029,0,0,0,1029,1030,0,0,0,0,0,0,0,0,1030,0,0,0,0,0,0,0,0,0
0,1030,0,0,0,0,0,0,0,0,1030,1029,0,0,0,0,1029,1029,1029,0,0,0,0,1029,0,0,0,0,0,0,0,0,0,1029,1029,1029,1029,1029,1029,1029,1029,0,0,0,1029,1030,1030,1030,1030,1030,1030,1030,1030,1030,1030,0,0,0,0,0,0,0,0,0
0,1030,1030,1030,1030,1030,1030,1030,1030,1030,1030,1029,0,0,0,0,3001,0,0,0,0,0,0,1029,0,0,0,0,0,0,0,0,0,1029,1029,1029,1029,1029,1029,1029,1029,0,0,0,1029,0,0,0,0,0,0,0,0,0,0,0,0,0,0,0,0,0,0,0
0,0,0,0,0,0,0,0,0,0,0,1029,0,0,0,0,1029,1029,1029,1029,1029,1029,1029,1029,0,0,0,0,0,0,0,0,0,1029,1029,1029,1029,1029,1029,1029,1029,0,0,0,1029,0,0,0,0,0,0,0,0,0,0,0,0,0,0,0,0,0,0,0
0,0,0,0,0,0,0,0,0,0,0,1029,0,0,0,0,1029,1029,1029,1029,1029,1029,1029,1029,0,0,0,0,0,0,0,0,0,1029,1029,1029,1029,1029,1029,1029,1029,0,0,0,1029,0,0,0,0,0,0,0,0,0,0,0,0,0,0,0,0,0,0,0
0,0,0,0,0,0,0,0,0,0,0,1029,0,0,0,0,0,0,0,0,0,0,0,0,0,0,0,0,0,0,0,0,0,0,0,0,0,0,0,0,0,0,0,0,1029,0,0,0,0,0,0,0,0,0,0,0,0,0,0,0,0,0,0,0
0,0,0,0,0,0,0,0,0,0,0,1029,1029,1029,1029,1029,1029,1029,1029,1029,1029,1029,1029,1029,1029,1029,1029,1029,3002,1029,1029,1029,1029,1029,1029,1029,1029,1029,1029,1029,1029,1029,1029,1029,1029,0,0,0,0,0,0,0,0,0,0,0,0,0,0,0,0,0,0,0
0,0,0,0,0,0,0,0,0,0,0,0,0,0,0,0,0,0,0,0,0,0,0,0,1029,0,0,0,0,0,0,0,1029,0,0,0,0,0,0,0,0,0,0,0,0,0,0,0,0,0,0,0,0,0,0,0,0,0,0,0,0,0,0,0
0,0,0,0,0,0,0,0,0,0,0,0,0,0,0,0,0,0,0,0,0,0,0,0,1029,0,0,0,0,0,0,0,1029,0,0,0,0,0,0,0,0,0,0,0,0,0,0,0,0,0,0,0,0,0,0,0,0,0,0,0,0,0,0,0
0,0,0,0,0,0,0,0,0,0,0,0,0,0,0,0,0,0,0,0,0,0,0,0,1029,0,0,0,0,0,0,0,1029,0,0,0,0,0,0,0,0,0,0,0,0,0,0,0,0,0,0,0,0,0,0,0,0,0,0,0,0,0,0,0
0,0,0,0,0,0,0,0,0,0,0,0,0,0,0,0,0,0,0,0,0,0,0,0,1029,0,0,0,0,0,0,0,1029,0,0,0,0,0,0,0,0,0,0,0,0,0,0,0,0,0,0,0,0,0,0,0,0,0,0,0,0,0,0,0
0,0,0,0,0,0,0,0,0,0,0,0,0,0,0,0,0,0,0,0,0,0,0,0,1029,0,0,0,0,0,0,0,1029,0,0,0,0,0,0,0,0,0,0,0,0,0,0,0,0,0,0,0,0,0,0,0,0,0,0,0,0,0,0,0
0,0,0,0,0,0,0,0,0,0,0,0,0,0,0,0,0,0,0,0,0,0,0,0,1029,0,0,0,0,0,0,0,1029,0,0,0,0,0,0,0,0,0,0,0,0,0,0,0,0,0,0,0,0,0,0,0,0,0,0,0,0,0,0,0
0,0,0,0,0,0,0,0,0,0,0,0,0,0,0,0,0,0,0,0,0,0,0,0,1029,0,0,0,0,0,0,0,1029,0,0,0,0,0,0,0,0,0,0,0,0,0,0,0,0,0,0,0,0,0,0,0,0,0,0,0,0,0,0,0
0,0,0,0,0,0,0,0,0,0,0,0,0,0,0,0,0,0,0,0,0,0,0,0,1029,0,0,0,4010,0,0,0,1029,0,0,0,0,0,0,0,0,0,0,0,0,0,0,0,0,0,0,0,0,0,0,0,0,0,0,0,0,0,0,0
0,0,0,0,0,0,0,0,0,0,0,0,0,0,0,0,0,0,0,0,0,0,0,0,1029,0,0,0,0,0,0,0,1029,0,0,0,0,0,0,0,0,0,0,0,0,0,0,0,0,0,0,0,0,0,0,0,0,0,0,0,0,0,0,0
0,0,0,0,0,0,0,0,0,0,0,0,0,0,0,0,0,0,0,0,0,0,0,0,1029,1029,1029,1029,1029,1029,1029,1029,1029,0,0,0,0,0,0,0,0,0,0,0,0,0,0,0,0,0,0,0,0,0,0,0,0,0,0,0,0,0,0,0
0,0,0,0,0,0,0,0,0,0,0,0,0,0,0,0,0,0,0,0,0,0,0,0,0,0,0,0,0,0,0,0,0,0,0,0,0,0,0,0,0,0,0,0,0,0,0,0,0,0,0,0,0,0,0,0,0,0,0,0,0,0,0,0
0,0,0,0,0,0,0,0,0,0,0,0,0,0,0,0,0,0,0,0,0,0,0,0,0,0,0,0,0,0,0,0,0,0,0,0,0,0,0,0,0,0,0,0,0,0,0,0,0,0,0,0,0,0,0,0,0,0,0,0,0,0,0,0
0,0,0,0,0,0,0,0,0,0,0,0,0,0,0,0,0,0,0,0,0,0,0,0,0,0,0,0,0,0,0,0,0,0,0,0,0,0,0,0,0,0,0,0,0,0,0,0,0,0,0,0,0,0,0,0,0,0,0,0,0,0,0,0
0,0,0,0,0,0,0,0,0,0,0,0,0,0,0,0,0,0,0,0,0,0,0,0,0,0,0,0,0,0,0,0,0,0,0,0,0,0,0,0,0,0,0,0,0,0,0,0,0,0,0,0,0,0,0,0,0,0,0,0,0,0,0,0
0,0,0,0,0,0,0,0,0,0,0,0,0,0,0,0,0,0,0,0,0,0,0,0,0,0,0,0,0,0,0,0,0,0,0,0,0,0,0,0,0,0,0,0,0,0,0,0,0,0,0,0,0,0,0,0,0,0,0,0,0,0,0,0
0,0,0,0,0,0,0,0,0,0,0,0,0,0,0,0,0,0,0,0,0,0,0,0,0,0,0,0,0,0,0,0,0,0,0,0,0,0,0,0,0,0,0,0,0,0,0,0,0,0,0,0,0,0,0,0,0,0,0,0,0,0,0,0
0,0,0,0,0,0,0,0,0,0,0,0,0,0,0,0,0,0,0,0,0,0,0,0,0,0,0,0,0,0,0,0,0,0,0,0,0,0,0,0,0,0,0,0,0,0,0,0,0,0,0,0,0,0,0,0,0,0,0,0,0,0,0,0
0,0,0,0,0,0,0,0,0,0,0,0,0,0,0,0,0,0,0,0,0,0,0,0,0,0,0,0,0,0,0,0,0,0,0,0,0,0,0,0,0,0,0,0,0,0,0,0,0,0,0,0,0,0,0,0,0,0,0,0,0,0,0,0

0,0,0,0,0,0,0,0,0,0,0,0,0,0,0,0,0,0,0,0,0,0,0,0,0,0,0,0,0,0,0,0,0,0,0,0,0,0,0,0,0,0,0,0,0,0,0,0,0,0,0,0,0,0,0,0,0,0,0,0,0,0,0,0
0,0,0,0,0,0,0,0,0,0,0,0,0,0,0,0,0,0,0,0,0,0,0,0,0,0,0,0,0,0,0,0,0,0,0,0,0,0,0,0,0,0,0,0,0,0,0,0,0,0,0,0,0,0,0,0,0,0,0,0,0,0,0,0
0,0,0,0,0,0,0,0,0,0,0,0,0,0,0,0,0,0,0,0,0,0,0,0,0,0,0,0,0,0,0,0,0,0,0,0,0,0,0,0,0,0,0,0,0,0,0,0,0,0,0,0,0,0,0,0,0,0,0,0,0,0,0,0
0,0,0,0,0,0,0,0,0,0,0,0,0,0,0,0,0,0,0,0,0,0,0,0,0,9005,9005,9005,9005,9005,9005,9005,0,0,0,0,0,0,0,0,0,0,0,0,0,0,0,0,0,0,0,0,0,0,0,0,0,0,0,0,0,0,0,0
0,0,0,0,0,0,0,0,0,0,0,0,0,0,0,0,0,0,0,0,0,0,0,0,0,9005,9005,9005,9005,9005,9005,9005,0,0,0,0,0,0,0,0,0,0,0,0,0,0,9007,9007,9007,9007,9007,0,0,0,0,0,0,0,0,0,0,0,0,0
0,0,0,0,0,0,0,0,0,0,0,0,0,0,0,0,0,0,0,0,0,0,0,0,0,9005,9005,9005,9005,9005,9005,9005,0,9006,9006,9006,9006,9006,9006,9006,9006,9006,9006,9006,9006,0,9007,0,0,0,9007,0,0,0,0,0,0,0,0,0,0,0,0,0
0,0,0,0,0,0,0,0,0,0,0,0,0,0,0,0,0,0,0,0,0,0,0,0,0,9005,9005,9005,9005,9005,9005,9005,0,9006,9006,9006,9006,9006,9006,9006,9006,9006,9006,9006,9006,0,9007,0,0,0,9007,0,0,0,0,0,0,0,0,0,0,0,0,0
0,0,0,0,0,0,0,0,0,0,0,0,0,0,0,0,0,0,0,0,0,0,0,0,0,9005,9005,9005,9005,9005,9005,9005,0,9006,9006,9006,9006,9006,9006,9006,9006,9006,9006,9006,9006,0,9007,0,0,0,9007,0,0,0,0,0,0,0,0,0,0,0,0,0
0,0,0,0,0,0,0,0,0,0,0,0,0,0,0,0,0,0,0,0,0,0,0,0,0,9005,9005,9005,9005,9005,9005,9005,0,0,0,0,0,0,0,0,0,0,0,0,0,0,9007,9007,9007,9007,9007,0,0,0,0,0,0,0,0,0,0,0,0,0
0,0,0,0,0,0,0,0,0,0,0,0,0,0,0,0,0,0,0,0,0,0,0,0,0,9005,9005,9005,9005,9005,9005,9005,0,0,0,0,0,0,0,0,0,0,0,0,0,0,0,0,0,0,0,0,0,0,0,0,0,0,0,0,0,0,0,0
0,0,0,0,0,0,0,0,0,0,0,0,0,0,0,0,0,0,0,0,0,0,0,0,0,9005,9005,9005,9005,9005,9005,9005,0,0,0,0,0,0,0,0,0,0,0,0,0,0,0,0,0,0,0,0,0,0,0,0,0,0,0,0,0,0,0,0
0,0,0,0,0,0,0,0,0,0,0,0,0,0,0,0,0,0,0,0,0,0,0,0,0,9005,9005,9005,9005,9005,9005,9005,0,0,0,0,0,0,0,0,0,0,0,0,0,0,0,0,0,0,0,0,0,0,0,0,0,0,0,0,0,0,0,0
0,0,0,0,0,0,0,0,0,0,0,0,0,0,0,0,0,0,0,0,0,0,0,0,0,0,0,0,0,0,0,0,0,0,0,0,0,0,0,0,0,0,0,0,0,0,0,0,0,0,0,0,0,0,0,0,0,0,0,0,0,0,0,0
0,0,0,0,0,0,0,0,0,0,0,0,9001,9001,9001,9001,9001,9001,9001,9001,9001,9001,9001,9001,9001,9001,9001,9001,9001,9001,9001,9001,9001,9001,9001,9001,9001,9001,9001,9001,9001,9001,9001,9001,0,0,0,0,0,0,0,0,0,0,0,0,0,0,0,0,0,0,0,0
0,0,0,0,0,0,0,0,0,0,0,0,9001,9001,9001,9001,9001,9001,9001,9001,9001,9001,9001,9001,9001,9001,9001,9001,9001,9001,9001,9001,9001,9001,9001,9001,9001,9001,9001,9001,9001,9001,9001,9001,0,0,0,0,0,0,0,0,0,0,0,0,0,0,0,0,0,0,0,0
0,0,0,0,0,0,0,0,0,0,0,0,9001,9001,9001,9001,9001,9001,9001,9001,9001,9001,9001,9001,9001,9001,9001,9001,9001,9001,9001,9001,9001,9001,9001,9001,9001,9001,9001,9001,9001,9001,9001,9001,0,0,0,0,0,0,0,0,0,0,0,0,0,0,0,0,0,0,0,0
0,0,0,0,0,0,0,0,0,0,0,0,9001,9001,9001,9001,9001,9001,9001,9001,9001,9001,9001,9001,9001,9001,9001,9001,9001,9001,9001,9001,9001,9001,9001,9001,9001,9001,9001,9001,9001,9001,9001,9001,0,0,0,0,0,0,0,0,0,0,0,0,0,0,0,0,0,0,0,0
0,0,0,0,0,0,0,0,0,0,0,0,9001,9001,9001,9001,0,0,0,0,0,0,0,0,9001,9001,9001,9001,9001,9001,9001,9001,9001,0,0,0,0,0,0,0,0,9001,9001,9001,0,0,0,0,0,0,0,0,0,0,0,0,0,0,0,0,0,0,0,0
0,0,0,0,0,0,0,0,0,0,0,0,9001,9001,9001,9001,0,0,0,9008,0,0,0,0,9001,9001,9001,9001,9001,9001,9001,9001,9001,0,0,0,0,0,0,0,0,9001,9001,9001,0,0,0,0,0,0,0,0,0,0,0,0,0,0,0,0,0,0,0,0
0,0,0,0,0,0,0,0,0,0,0,0,9001,9001,9001,9001,0,0,0,9008,0,0,0,0,9001,9001,9001,9001,9001,9001,9001,9001,9001,0,0,0,0,0,0,0,0,9001,9001,9001,0,0,0,0,0,0,0,0,0,0,0,0,0,0,0,0,0,0,0,0
0,0,0,0,0,0,0,0,0,0,0,0,9001,9001,9001,9001,0,0,0,9008,9008,9008,0,0,9001,9001,9001,9001,9001,9001,9001,9001,9001,0,0,0,0,0,0,0,0,9001,9001,9001,0,0,0,0,0,0,0,0,0,0,0,0,0,0,0,0,0,0,0,0
0,0,9004,9004,9004,9004,9004,9004,9004,9004,0,0,9001,9001,9001,9001,0,0,0,9008,9008,9008,0,0,9001,9001,9001,9001,9001,9001,9001,9001,9001,0,0,0,0,0,0,0,0,9001,9001,9001,0,0,9003,9003,9003,9003,9003,9003,9003,9003,0,0,0,0,0,0,0,0,0,0
0,0,9004,9004,9004,9004,9004,9004,9004,9004,0,0,9001,9001,9001,9001,0,0,0,9008,9008,9008,0,0,9001,9001,9001,9001,9001,9001,9001,9001,9001,0,0,0,0,0,0,0,0,9001,9001,9001,0,0,9003,9003,9003,9003,9003,9003,9003,9003,0,0,0,0,0,0,0,0,0,0
0,0,9004,9004,9004,9004,9004,9004,9004,9004,9004,0,9001,9001,9001,9001,0,0,0,0,0,0,0,0,9001,9001,9001,9001,9001,9001,9001,9001,9001,0,0,0,0,0,0,0,0,9001,9001,9001,0,9003,9003,9003,9003,9003,9003,9003,9003,9003,0,0,0,0,0,0,0,0,0,0
0,0,9004,9004,9004,9004,9004,9004,9004,9004,9004,0,9001,9001,9001,9001,0,0,0,0,0,0,0,0,9001,9001,9001,9001,9001,9001,9001,9001,9001,0,0,0,0,0,0,0,0,9001,9001,9001,0,9003,9003,9003,9003,9003,9003,9003,9003,9003,0,0,0,0,0,0,0,0,0,0
0,0,9004,9004,9004,9004,9004,9004,9004,9004,9004,0,9001,9001,9001,9001,9001,9001,9001,9001,9001,9001,9001,9001,9001,9001,9001,9001,9001,9001,9001,9001,9001,9001,9001,9001,9001,9001,9001,9001,9001,9001,9001,9001,0,9003,9003,9003,9003,9003,9003,9003,9003,9003,0,0,0,0,0,0,0,0,0,0
0,0,9004,9004,9004,9004,9004,9004,9004,9004,9004,0,9001,9001,9001,9001,9001,9001,9001,9001,9001,9001,9001,9001,9001,9001,9001,9001,9001,9001,9001,9001,9001,9001,9001,9001,9001,9001,9001,9001,9001,9001,9001,9001,0,9003,9003,9003,9003,9003,9003,9003,9003,9003,0,0,0,0,0,0,0,0,0,0
0,0,9004,9004,9004,9004,9004,9004,9004,9004,9004,0,9001,9001,9001,9001,0,0,0,0,0,0,0,0,9001,9001,9001,9001,9001,9001,9001,9001,9001,0,0,0,0,0,0,0,0,9001,9001,9001,0,9003,9003,9003,9003,9003,9003,9003,9003,9003,0,0,0,0,0,0,0,0,0,0
0,0,9004,9004,9004,9004,9004,9004,9004,9004,0,0,9001,9001,9001,9001,0,0,0,0,0,0,0,0,9001,9001,9001,9001,9001,9001,9001,9001,9001,0,0,0,0,0,0,0,0,9001,9001,9001,0,0,9003,9003,9003,9003,9003,9003,9003,9003,0,0,0,0,0,0,0,0,0,0
0,0,9004,9004,9004,9004,9004,9004,9004,9004,0,0,9001,9001,9001,9001,0,0,0,0,0,0,0,0,9001,9001,9001,9001,9001,9001,9001,9001,9001,0,0,0,0,0,0,0,0,9001,9001,9001,0,0,9003,9003,9003,9003,9003,9003,9003,9003,0,0,0,0,0,0,0,0,0,0
0,0,9004,9004,9004,9004,9004,9004,9004,9004,0,0,9001,9001,9001,9001,0,0,0,0,0,0,0,0,9001,9001,9001,9001,9001,9001,9001,9001,9001,0,0,0,0,0,0,0,0,9001,9001,9001,0,0,9003,9003,9003,9003,9003,9003,9003,9003,0,0,0,0,0,0,0,0,0,0
0,0,9004,9004,9004,9004,9004,9004,9004,9004,0,0,9001,9001,9001,9001,0,0,0,0,0,0,0,0,9001,9001,9001,9001,9001,9001,9001,9001,9001,0,0,0,0,0,0,0,0,9001,9001,9001,0,0,9003,9003,9003,9003,9003,9003,9003,9003,0,0,0,0,0,0,0,0,0,0
0,0,9004,9004,9004,9004,9004,9004,9004,9004,0,0,9001,9001,9001,9001,0,0,0,0,0,0,0,0,9001,9001,9001,9001,9001,9001,9001,9001,9001,0,0,0,0,0,0,0,0,9001,9001,9001,0,0,9003,9003,9003,9003,9003,9003,9003,9003,0,0,0,0,0,0,0,0,0,0
0,0,9004,9004,9004,9004,9004,9004,9004,9004,0,0,9001,9001,9001,9001,0,0,0,0,0,0,0,0,9001,9001,9001,9001,9001,9001,9001,9001,9001,0,0,0,0,0,0,0,0,9001,9001,9001,0,0,9003,9003,9003,9003,9003,9003,9003,9003,0,0,0,0,0,0,0,0,0,0
0,0,9004,9004,9004,9004,9004,9004,9004,9004,0,0,9001,9001,9001,9001,0,0,0,0,0,0,0,0,9001,9001,9001,9001,9001,9001,9001,9001,9001,0,0,0,0,0,0,0,0,9001,9001,9001,0,0,9003,9003,9003,9003,9003,9003,9003,9003,0,0,0,0,0,0,0,0,0,0
0,0,9004,9004,9004,9004,9004,9004,9004,9004,0,0,9001,9001,9001,9001,9001,9001,9001,9001,9001,9001,9001,9001,9001,9001,9001,9001,9001,9001,9001,9001,9001,9001,9001,9001,9001,9001,9001,9001,9001,9001,9001,9001,0,0,9003,9003,9003,9003,9003,9003,9003,9003,0,0,0,0,0,0,0,0,0,0
0,0,9004,9004,9004,9004,9004,9004,9004,9004,0,0,9001,9001,9001,9001,9001,9001,9001,9001,9001,9001,9001,9001,9001,9001,9001,9001,9001,9001,9001,9001,9001,9001,9001,9001,9001,9001,9001,9001,9001,9001,9001,9001,0,0,9003,9003,9003,9003,9003,9003,9003,9003,0,0,0,0,0,0,0,0,0,0
0,0,9004,9004,9004,9004,9004,9004,9004,9004,0,0,9001,9001,9001,9001,0,0,0,0,0,0,0,0,9001,9001,9001,9001,9001,9001,9001,9001,9001,0,0,0,0,0,0,0,0,9001,9001,9001,0,0,9003,9003,9003,9003,9003,9003,9003,9003,0,0,0,0,0,0,0,0,0,0
0,0,9004,9004,9004,9004,9004,9004,9004,9004,0,0,9001,9001,9001,9001,0,0,0,9009,9009,9009,9009,0,9001,9001,9001,9001,9001,9001,9001,9001,9001,0,0,0,0,0,0,0,0,9001,9001,9001,0,0,9003,9003,9003,9003,9003,9003,9003,9003,0,0,0,0,0,0,0,0,0,0
0,0,9004,9004,9004,9004,9004,9004,9004,9004,0,0,9001,9001,9001,9001,0,0,0,9009,9009,9009,9009,0,9001,9001,9001,9001,9001,9001,9001,9001,9001,0,0,0,0,0,0,0,0,9001,9001,9001,0,0,9003,9003,9003,9003,9003,9003,9003,9003,0,0,0,0,0,0,0,0,0,0
0,0,9004,9004,9004,9004,9004,9004,9004,9004,0,0,9001,9001,9001,9001,0,0,0,9009,9009,9009,9009,0,9001,9001,9001,9001,9001,9001,9001,9001,9001,0,0,0,0,0,0,0,0,9001,9001,9001,0,0,0,0,0,0,0,0,0,0,0,0,0,0,0,0,0,0,0,0
0,0,0,0,0,0,0,0,0,0,0,0,9001,9001,9001,9001,0,9009,9009,9009,9009,9009,9009,0,9001,9001,9001,9001,9001,9001,9001,9001,9001,0,0,0,0,0,0,0,0,9001,9001,9001,0,0,0,0,0,0,0,0,0,0,0,0,0,0,0,0,0,0,0,0
0,0,0,0,0,0,0,0,0,0,0,0,9001,9001,9001,9001,0,0,0,0,0,0,0,0,9001,9001,9001,9001,9001,9001,9001,9001,9001,0,0,0,0,0,0,0,0,9001,9001,9001,0,0,0,0,0,0,0,0,0,0,0,0,0,0,0,0,0,0,0,0
0,0,0,0,0,0,0,0,0,0,0,0,9001,9001,9001,9001,0,0,0,0,0,0,0,0,9001,9001,9001,9001,9001,9001,9001,9001,9001,0,0,0,0,0,0,0,0,9001,9001,9001,0,0,0,0,0,0,0,0,0,0,0,0,0,0,0,0,0,0,0,0
0,0,0,0,0,0,0,0,0,0,0,0,9001,9001,9001,9001,9001,9001,9001,9001,9001,9001,9001,9001,9001,9001,9001,9001,9001,9001,9001,9001,9001,9001,9001,9001,9001,9001,9001,9001,9001,9001,9001,9001,0,0,0,0,0,0,0,0,0,0,0,0,0,0,0,0,0,0,0,0
0,0,0,0,0,0,0,0,0,0,0,0,0,0,0,0,0,0,0,0,0,0,0,0,0,0,0,0,0,0,0,0,0,0,0,0,0,0,0,0,0,0,0,0,0,0,0,0,0,0,0,0,0,0,0,0,0,0,0,0,0,0,0,0
0,0,0,0,0,0,0,0,0,0,0,0,0,0,0,0,0,0,0,0,0,0,0,0,0,9002,9002,9002,9002,9002,9002,9002,0,0,0,0,0,0,0,0,0,0,0,0,0,0,0,0,0,0,0,0,0,0,0,0,0,0,0,0,0,0,0,0
0,0,0,0,0,0,0,0,0,0,0,0,0,0,0,0,0,0,0,0,0,0,0,0,0,9002,9002,9002,9002,9002,9002,9002,0,0,0,0,0,0,0,0,0,0,0,0,0,0,0,0,0,0,0,0,0,0,0,0,0,0,0,0,0,0,0,0
0,0,0,0,0,0,0,0,0,0,0,0,0,0,0,0,0,0,0,0,0,0,0,0,0,9002,9002,9002,9002,9002,9002,9002,0,0,0,0,0,0,0,0,0,0,0,0,0,0,0,0,0,0,0,0,0,0,0,0,0,0,0,0,0,0,0,0
0,0,0,0,0,0,0,0,0,0,0,0,0,0,0,0,0,0,0,0,0,0,0,0,0,9002,9002,9002,9002,9002,9002,9002,0,0,0,0,0,0,0,0,0,0,0,0,0,0,0,0,0,0,0,0,0,0,0,0,0,0,0,0,0,0,0,0
0,0,0,0,0,0,0,0,0,0,0,0,0,0,0,0,0,0,0,0,0,0,0,0,0,9002,9002,9002,9002,9002,9002,9002,0,0,0,0,0,0,0,0,0,0,0,0,0,0,0,0,0,0,0,0,0,0,0,0,0,0,0,0,0,0,0,0
0,0,0,0,0,0,0,0,0,0,0,0,0,0,0,0,0,0,0,0,0,0,0,0,0,9002,9002,9002,9002,9002,9002,9002,0,0,0,0,0,0,0,0,0,0,0,0,0,0,0,0,0,0,0,0,0,0,0,0,0,0,0,0,0,0,0,0
0,0,0,0,0,0,0,0,0,0,0,0,0,0,0,0,0,0,0,0,0,0,0,0,0,9002,9002,9002,9002,9002,9002,9002,0,0,0,0,0,0,0,0,0,0,0,0,0,0,0,0,0,0,0,0,0,0,0,0,0,0,0,0,0,0,0,0
0,0,0,0,0,0,0,0,0,0,0,0,0,0,0,0,0,0,0,0,0,0,0,0,0,9002,9002,9002,9002,9002,9002,9002,0,0,0,0,0,0,0,0,0,0,0,0,0,0,0,0,0,0,0,0,0,0,0,0,0,0,0,0,0,0,0,0
0,0,0,0,0,0,0,0,0,0,0,0,0,0,0,0,0,0,0,0,0,0,0,0,0,9002,9002,9002,9002,9002,9002,9002,0,0,0,0,0,0,0,0,0,0,0,0,0,0,0,0,0,0,0,0,0,0,0,0,0,0,0,0,0,0,0,0
0,0,0,0,0,0,0,0,0,0,0,0,0,0,0,0,0,0,0,0,0,0,0,0,0,0,0,0,0,0,0,0,0,0,0,0,0,0,0,0,0,0,0,0,0,0,0,0,0,0,0,0,0,0,0,0,0,0,0,0,0,0,0,0
0,0,0,0,0,0,0,0,0,0,0,0,0,0,0,0,0,0,0,0,0,0,0,0,0,0,0,0,0,0,0,0,0,0,0,0,0,0,0,0,0,0,0,0,0,0,0,0,0,0,0,0,0,0,0,0,0,0,0,0,0,0,0,0
0,0,0,0,0,0,0,0,0,0,0,0,0,0,0,0,0,0,0,0,0,0,0,0,0,0,0,0,0,0,0,0,0,0,0,0,0,0,0,0,0,0,0,0,0,0,0,0,0,0,0,0,0,0,0,0,0,0,0,0,0,0,0,0
0,0,0,0,0,0,0,0,0,0,0,0,0,0,0,0,0,0,0,0,0,0,0,0,0,0,0,0,0,0,0,0,0,0,0,0,0,0,0,0,0,0,0,0,0,0,0,0,0,0,0,0,0,0,0,0,0,0,0,0,0,0,0,0
0,0,0,0,0,0,0,0,0,0,0,0,0,0,0,0,0,0,0,0,0,0,0,0,0,0,0,0,0,0,0,0,0,0,0,0,0,0,0,0,0,0,0,0,0,0,0,0,0,0,0,0,0,0,0,0,0,0,0,0,0,0,0,0
0,0,0,0,0,0,0,0,0,0,0,0,0,0,0,0,0,0,0,0,0,0,0,0,0,0,0,0,0,0,0,0,0,0,0,0,0,0,0,0,0,0,0,0,0,0,0,0,0,0,0,0,0,0,0,0,0,0,0,0,0,0,0,0
0,0,0,0,0,0,0,0,0,0,0,0,0,0,0,0,0,0,0,0,0,0,0,0,0,0,0,0,0,0,0,0,0,0,0,0,0,0,0,0,0,0,0,0,0,0,0,0,0,0,0,0,0,0,0,0,0,0,0,0,0,0,0,0
0,0,0,0,0,0,0,0,0,0,0,0,0,0,0,0,0,0,0,0,0,0,0,0,0,0,0,0,0,0,0,0,0,0,0,0,0,0,0,0,0,0,0,0,0,0,0,0,0,0,0,0,0,0,0,0,0,0,0,0,0,0,0,0
0,0,0,0,0,0,0,0,0,0,0,0,0,0,0,0,0,0,0,0,0,0,0,0,0,0,0,0,0,0,0,0,0,0,0,0,0,0,0,0,0,0,0,0,0,0,0,0,0,0,0,0,0,0,0,0,0,0,0,0,0,0,0,0
