64
1093
1034
0,0,0,0,0,0,0,0,0,0,0,0,0,0,0,0,0,0,0,0,0,0,0,0,0,0,0,0,0,0,0,0,0,0,0,0,0,0,0,0,0,0,0,0,0,0,0,0,0,0,0,0,0,0,0,0,0,0,0,0,0,0,0,0
0,1089,1089,1089,1089,1089,1089,1089,1089,1089,1089,1089,1089,1089,1089,1089,1089,1089,1089,1089,1089,1089,1089,1089,1089,1089,1089,1089,1089,1089,1089,1089,1089,1089,1089,1089,1089,1089,1089,1089,1089,1089,1089,1089,1089,1089,1089,1089,1089,1089,1089,1089,1089,1089,1089,1089,1089,1089,1089,1089,1089,1089,1089,0
0,1089,2036,0,0,0,0,2008,0,0,0,2034,1089,5011,2036,0,0,0,0,0,0,0,2008,0,0,0,0,0,0,0,0,0,0,0,0,0,0,0,0,0,0,0,0,0,0,0,0,0,0,2034,5003,1089,2036,0,0,0,0,2007,0,0,0,2034,1089,0
0,1089,0,0,0,0,0,0,0,0,0,0,3001,0,2006,0,0,0,0,0,0,5004,0,0,0,0,0,0,0,0,0,0,5004,0,0,0,0,0,0,0,0,0,0,0,5004,0,0,0,0,0,0,3001,5007,0,0,0,0,0,0,0,0,0,1089,0
0,1089,0,0,1086,1086,1086,1086,1086,1086,0,0,1089,0,0,0,0,0,0,0,0,0,0,0,0,0,0,0,0,0,0,0,0,0,0,0,0,0,0,0,0,0,0,0,0,0,0,0,0,2005,0,1089,0,0,1086,1086,1086,1086,1086,1086,0,0,1089,0
0,1089,0,0,1086,4007,0,0,4012,1086,0,0,1089,0,2033,0,0,0,0,0,0,0,0,0,0,0,0,0,0,0,0,0,0,0,0,0,0,2007,0,0,0,0,0,0,0,0,0,0,0,2035,5003,1089,2006,0,1086,4012,0,0,4007,1086,0,0,1089,0
0,1089,0,0,1086,0,0,0,0,1086,0,0,1089,1089,1089,1089,1089,1089,1089,1089,1089,1089,1089,1089,1085,1085,1085,1085,1085,1085,1085,1085,3002,1085,1085,1085,1085,1085,1085,1085,1085,1089,1089,1089,1089,1089,1089,1089,1089,1089,1089,1089,0,0,1086,0,4008,0,0,1086,0,0,1089,0
0,1089,2006,0,1086,0,5004,0,0,1086,0,2005,1089,0,0,0,0,0,0,0,0,0,0,0,1085,2036,0,0,0,0,0,0,0,0,0,0,0,0,0,2034,1085,0,0,0,0,0,0,0,0,0,0,1089,0,5007,1086,0,0,5004,0,1086,0,0,1089,0
0,1089,0,0,1086,4002,0,0,4002,1086,0,0,1089,0,0,0,0,0,0,0,0,0,0,0,1085,0,0,0,1085,1085,1085,0,4006,0,1085,1085,1085,0,0,0,1085,0,0,0,0,0,0,0,0,0,0,1089,0,0,1086,4002,0,0,4002,1086,0,0,1089,0
0,1089,0,0,1086,1086,3002,1086,1086,1086,0,0,1089,0,0,0,0,0,0,0,0,0,0,0,1085,0,0,0,1085,1089,1085,0,4012,0,1085,1089,1085,0,0,0,1085,0,0,0,0,0,0,0,0,0,0,1089,0,0,1086,1086,1086,3002,1086,1086,0,2005,1089,0
0,1089,0,0,0,0,0,0,0,0,0,0,1089,0,0,0,0,0,0,0,0,0,0,0,1085,0,0,0,1085,1089,1085,0,0,0,1085,1089,1085,0,0,0,1085,0,0,0,0,0,0,0,0,0,0,1089,0,5007,0,0,5007,5001,5007,0,0,0,1089,0
0,1089,2033,0,0,0,2007,0,0,0,0,2035,1089,0,0,0,0,0,0,0,0,0,0,0,1085,2006,0,0,1085,1089,1085,0,0,0,1085,1089,1085,0,0,2005,1085,0,0,0,0,0,0,0,0,0,0,1089,2033,0,0,0,2008,0,0,0,5007,2035,1089,0
0,1089,1089,3002,1089,1089,1089,1089,1089,1089,1089,1089,1089,0,0,0,0,0,0,0,0,0,0,0,1085,0,0,0,1085,1089,1085,0,5004,0,1085,1089,1085,0,0,0,1085,0,0,0,0,0,0,0,0,0,0,1089,1089,1089,1089,1089,1089,1089,1089,1089,3002,1089,1089,0
0,1089,0,0,0,0,1089,0,0,0,0,0,0,0,0,1085,1085,1085,1085,1085,1085,1085,1085,1085,1085,0,0,0,1085,1089,1085,0,0,0,1085,1089,1085,0,0,0,1085,1085,1085,1085,1085,1085,1085,1085,1085,0,0,0,0,0,0,0,0,1089,5003,0,0,5003,1089,0
0,1089,2036,0,2008,2034,1089,0,0,0,0,0,0,0,0,1085,2036,0,0,0,0,0,0,0,0,2034,0,0,1085,1089,1085,0,0,0,1085,1089,1085,0,0,2035,0,0,0,0,0,0,0,2034,1085,0,0,0,0,0,0,0,0,1089,2036,2008,0,2034,1089,0
0,1089,0,0,0,0,1089,0,0,0,0,0,0,0,0,1085,0,4007,1085,1085,1085,1085,0,0,0,0,0,0,1085,1085,1085,0,0,0,1085,1085,1085,0,0,0,0,0,1085,1085,1085,1085,4007,0,1085,0,0,0,0,0,0,0,0,1089,0,0,0,0,1089,0
0,1089,0,5004,0,0,1089,0,0,0,0,0,0,0,0,1085,0,0,1085,1089,1089,1085,0,2036,0,0,0,0,0,5003,0,0,0,0,0,5003,0,0,0,0,2034,0,1085,1089,1089,1085,0,0,1085,0,0,0,0,0,0,0,0,1089,0,0,0,0,1089,0
0,1089,0,0,0,0,1089,0,0,0,0,0,0,0,0,1085,0,0,1085,1089,1089,1085,0,2014,0,0,0,0,0,0,0,0,0,0,0,0,0,0,0,0,2013,0,1085,1089,1089,1085,0,0,1085,0,1082,1082,1082,1082,1082,1082,1082,1089,0,0,5004,0,1089,0
0,1089,2006,0,0,0,1089,0,0,0,0,0,0,0,0,1085,2006,5004,1085,1089,1089,1085,0,0,0,0,0,0,0,0,0,0,5008,0,0,0,0,0,0,0,0,0,1085,1089,1089,1085,5004,2005,1085,0,1082,4003,1082,2030,1082,4012,1082,1089,0,0,0,0,1089,0
0,1089,0,0,0,0,1089,0,0,0,0,0,0,0,0,1085,0,0,1085,1089,1089,1085,0,2033,0,0,0,5004,0,0,0,0,0,0,5008,0,0,5004,0,0,2035,0,1085,1089,1089,1085,0,0,1085,0,1082,0,1082,0,1082,0,1082,1089,0,0,0,0,1089,0
0,1089,0,0,0,0,1089,0,0,0,0,0,0,0,0,1085,0,0,1085,1089,1089,1085,5006,0,0,0,0,0,0,0,5008,0,0,0,0,0,0,0,0,0,0,5006,1085,1089,1089,1085,0,0,1085,0,1082,0,1082,0,1082,0,1082,1089,0,0,0,0,1089,0
0,1089,0,0,0,0,1089,0,0,0,0,0,0,0,0,1085,0,4002,1085,1085,1085,1085,0,0,0,0,0,0,5008,0,0,0,0,0,0,0,0,5008,0,0,0,0,1085,1085,1085,1085,4002,0,1085,0,1082,3002,1082,3002,1082,3002,1082,1089,0,0,0,0,1089,0
0,1089,0,0,0,0,1089,0,0,0,0,0,0,0,0,1085,2033,0,0,0,0,0,0,0,0,0,0,0,0,0,5005,0,5005,0,5005,0,0,0,0,0,0,0,0,0,0,0,0,2035,1085,0,1082,0,0,0,0,0,1082,1089,0,0,0,0,1089,0
0,1089,0,0,0,0,1089,0,0,0,0,0,0,0,0,1085,1085,1085,1085,1085,1085,1085,1085,1085,1085,1085,3002,1085,1085,1085,1085,1085,1085,1085,1085,1085,1085,1085,3002,1085,1085,1085,1085,1085,1085,1085,1085,1085,1085,0,1082,0,2036,0,2034,0,1082,1089,0,0,0,0,1089,0
0,1089,0,0,0,0,1089,0,0,0,0,0,0,0,0,0,0,0,0,0,0,0,1082,1082,1082,0,0,0,1082,1082,1082,0,2042,0,1082,1082,1082,0,0,0,1082,1082,0,0,0,0,0,0,0,0,1082,0,0,0,0,0,1082,1089,0,0,0,0,1089,0
0,1089,0,0,0,0,1089,0,0,0,0,0,0,0,0,0,0,0,0,0,0,0,1082,5006,0,0,0,0,0,5006,1082,0,0,0,1082,5006,0,0,0,0,5006,1082,0,0,0,0,0,0,0,0,1082,5008,0,5004,0,0,1082,1089,0,0,0,0,1089,0
0,1089,0,0,0,0,1089,0,0,0,0,0,0,0,0,0,0,0,0,0,0,0,1082,0,0,0,2017,0,0,0,3003,0,0,0,3005,0,0,0,2017,0,0,1082,0,0,0,0,0,0,0,0,1082,0,0,0,0,5005,1082,1089,0,0,0,0,1089,0
0,1089,0,0,0,0,1089,0,0,0,0,0,0,0,0,0,0,0,0,0,0,0,1082,0,0,0,5004,0,0,0,1082,1012,3002,1012,1082,0,0,0,5004,0,0,1082,0,0,0,0,0,0,0,0,1082,0,2006,0,0,0,1082,1089,0,0,0,0,1089,0
0,1089,0,0,0,0,1089,0,0,0,0,0,0,0,0,0,0,0,0,0,0,0,1082,0,0,0,0,0,0,4001,1082,1012,4011,1012,1082,4001,0,0,0,0,0,1082,0,0,0,0,0,0,0,0,1082,0,0,0,0,0,1082,1089,0,0,5004,0,1089,0
0,1089,0,0,0,0,1089,0,0,0,0,1082,1082,1082,1082,1082,1082,1082,1082,1082,1082,1082,1082,1082,3002,1082,1082,1082,1082,1082,1082,1012,1012,1012,1082,1082,1082,1082,1082,3006,1082,1082,1082,1082,1082,1082,1082,1082,1082,1082,1082,5008,0,5008,0,5005,1082,1089,0,0,0,0,1089,0
0,1089,0,0,0,0,1089,0,0,0,0,1082,4002,0,0,0,0,1082,5014,0,0,0,0,0,0,0,5014,1082,0,0,0,0,0,0,0,0,1082,5014,0,0,0,0,5014,1082,0,0,0,0,0,0,0,0,0,0,0,0,1082,1089,0,0,0,0,1089,0
0,1089,0,5004,0,0,1089,0,0,0,0,1082,0,0,0,0,0,3001,0,0,0,0,0,0,0,0,0,1082,0,0,0,0,0,0,0,0,1082,0,0,0,0,0,0,1082,0,2036,0,0,5008,0,0,0,2034,0,2005,0,1082,1089,0,0,0,0,1089,0
0,1089,0,0,0,0,1089,0,0,0,0,1082,5008,0,5004,0,0,1082,0,0,0,0,5004,0,0,0,0,1082,0,0,0,0,0,0,0,0,1082,0,0,5004,0,0,0,3001,0,2033,0,0,0,2007,0,0,0,5004,2035,0,1082,1089,0,0,0,0,1089,0
0,1089,0,0,0,0,1089,0,0,0,0,1082,0,0,0,5008,0,1082,5014,0,0,0,0,0,0,0,5014,1082,0,0,0,0,0,0,0,0,1082,5014,0,0,0,0,5014,1082,0,0,0,5008,0,0,0,5008,0,0,5008,0,1082,1089,0,0,0,0,1089,0
0,1089,0,0,0,0,1089,0,0,0,0,1082,5005,0,0,0,0,1082,1082,1082,1082,1082,1082,1082,3002,1082,1082,1082,1082,1082,1082,1082,1082,1082,1082,1082,1082,1082,1082,3002,1082,1082,1082,1082,1082,1082,1082,1082,1082,1082,1082,1082,1082,1082,1082,1082,1082,1089,2006,0,0,2005,1089,0
0,1089,0,0,0,0,1089,0,0,0,0,1082,0,5008,0,5008,0,1082,0,1082,5014,0,0,0,0,0,0,0,0,0,5014,1082,5014,0,0,0,0,0,0,0,0,0,5014,1082,0,0,0,0,0,0,0,0,0,0,0,0,0,1089,0,0,0,0,1089,0
0,1089,0,0,0,0,1089,0,0,0,0,1082,0,0,0,0,0,1082,0,1082,0,2036,0,0,0,0,0,0,0,2034,0,1082,0,2036,0,0,0,0,0,0,0,2034,0,1082,0,0,0,0,0,0,0,0,0,0,0,0,0,1089,0,0,0,0,1089,0
0,1089,0,0,0,2005,1089,0,0,0,0,1082,5005,0,5004,0,0,1082,0,1082,0,2014,0,0,5004,0,0,0,0,2013,0,1082,0,2014,0,0,0,0,0,5004,0,2013,0,1082,0,0,0,0,0,0,0,0,0,0,0,0,0,1089,0,0,0,0,1089,0
0,1089,0,0,0,0,1089,0,0,0,0,1082,0,0,2017,0,0,1082,0,1082,0,2033,0,0,0,0,0,0,0,2035,0,1082,0,2033,0,0,0,0,0,0,0,2035,0,1082,0,0,0,0,0,0,0,0,0,0,0,0,0,1089,0,0,0,0,1089,0
0,1089,0,0,0,0,1089,0,0,0,0,1082,0,5008,0,5008,0,1082,0,1082,4003,0,0,0,0,0,0,0,0,0,4012,1082,4012,0,0,0,0,0,0,0,0,0,4003,1082,0,0,0,0,0,0,0,0,0,0,0,0,0,1089,0,0,0,0,1089,0
0,1089,0,0,0,0,1089,0,0,0,0,1082,0,0,0,0,0,1082,0,1082,1082,1082,1082,3002,1082,1082,1082,1082,1082,1082,1082,1082,1082,1082,1082,1082,1082,1082,1082,3002,1082,1082,1082,1082,0,0,0,0,0,0,0,0,0,0,0,0,0,1089,0,0,0,0,1089,0
0,1089,0,0,0,0,1089,0,0,0,0,1082,3002,1082,3002,1082,3002,1082,0,1087,1087,1087,0,0,0,1087,1087,1087,1087,1087,1087,1087,1087,1087,1087,1087,1087,1087,0,0,0,1087,1087,1087,0,1089,0,0,0,1089,1089,1089,1089,0,1089,0,0,1089,0,0,5004,0,1089,0
0,1089,0,0,0,0,1089,0,0,0,0,1082,0,1082,0,1082,0,1082,0,1087,4003,0,0,0,0,0,4012,1087,0,0,0,2042,0,0,0,1087,5014,2002,0,5004,0,2002,5014,1087,0,1089,0,0,0,1089,0,0,1089,0,1089,0,0,1089,0,0,0,0,1089,0
0,1089,0,0,0,0,1089,0,0,0,0,1082,0,1082,0,1082,0,1082,0,1087,0,0,0,0,0,0,0,1087,0,0,4003,0,4003,0,0,1087,0,0,2002,0,2002,0,0,1087,0,1089,0,0,0,1089,0,0,1089,0,1089,0,0,1089,0,0,0,0,1089,0
0,1089,0,0,0,0,1089,0,0,0,0,1082,0,1082,0,1082,0,1082,0,1087,0,0,0,5004,0,0,0,1087,1087,1087,1087,3002,1087,1087,1087,1087,0,0,0,2010,0,0,0,1087,0,1089,0,0,0,1089,0,0,1089,0,1089,0,0,1089,0,0,0,0,1089,0
0,1089,0,5004,0,0,1089,0,0,0,0,1082,4003,1082,2025,1082,4012,1082,0,1087,0,0,0,0,0,0,0,1087,0,0,0,0,0,0,0,1087,0,0,0,0,0,0,0,1087,0,1089,0,0,0,1089,0,0,1089,0,1089,0,0,1089,0,0,0,0,1089,0
0,1089,0,0,0,0,1089,0,0,0,0,1082,1082,1082,1082,1082,1082,1082,0,1087,0,0,0,0,0,0,0,1087,0,4007,0,0,0,4012,0,1087,0,0,0,0,0,0,0,1087,0,1089,0,0,0,1089,0,0,1089,0,1089,0,0,1089,0,0,0,0,1089,0
0,1089,0,0,0,0,1089,0,0,0,0,0,0,0,0,0,0,0,0,1087,0,0,0,0,0,0,0,1087,0,0,0,0,0,0,0,1087,0,0,0,0,0,0,0,1087,0,1089,0,0,0,1089,0,0,1089,0,1089,0,0,1089,0,0,0,0,1089,0
0,1089,0,0,0,0,1089,0,0,0,0,0,0,0,0,0,0,0,0,1087,0,0,0,0,0,0,0,1087,0,0,0,5004,0,0,0,1087,0,0,0,0,0,0,0,1087,0,1089,1089,1089,0,1089,1089,1089,1089,0,1089,1089,1089,1089,0,0,0,0,1089,0
0,1089,2033,2007,0,2035,1089,0,0,0,0,0,0,0,0,0,0,0,0,1087,0,0,0,2009,0,0,0,1087,0,0,0,0,0,0,0,1087,0,0,0,0,0,0,0,1087,0,0,0,0,0,0,0,0,0,0,0,0,0,1089,2033,0,2007,2035,1089,0
0,1089,0,0,0,0,1089,0,0,0,0,0,0,0,0,0,0,0,0,1087,0,0,2001,0,2001,0,0,1087,0,0,0,0,0,0,0,1087,0,0,0,5004,0,0,0,1087,0,0,0,0,0,0,0,0,0,0,0,0,0,1089,0,0,0,0,1089,0
0,1089,1089,3002,1089,1089,1089,1089,1089,1089,1089,1089,1089,0,0,0,0,0,0,1087,0,2001,0,5004,0,2001,0,1087,0,0,0,0,0,0,0,1087,0,0,0,0,0,0,0,1087,0,0,0,0,0,0,0,1089,1089,1089,1089,1089,1089,1089,1089,1089,3002,1089,1089,0
0,1089,2036,0,0,0,2007,0,0,0,0,2034,1089,0,0,0,0,0,0,1087,5014,0,0,0,0,0,5014,1087,0,0,0,0,0,0,0,1087,4003,0,0,0,0,0,4012,1087,0,0,0,0,0,0,0,1089,2036,0,0,0,0,0,2007,0,0,2034,1089,0
0,1089,0,0,0,0,0,0,0,0,0,0,1089,0,0,0,0,0,0,1087,1087,1087,1087,3002,1087,1087,1087,1087,1087,1087,0,0,0,0,0,1087,1087,1087,1087,3002,1087,1087,1087,1087,1087,1087,0,0,0,0,0,1089,0,0,0,0,0,0,0,0,0,0,1089,0
0,1089,0,0,1086,1086,3002,1086,1086,1086,0,0,1089,0,0,0,0,0,0,1087,0,0,0,0,0,0,0,0,0,1087,0,0,0,0,0,1087,0,0,0,0,0,0,0,0,4002,1087,0,0,0,0,0,1089,2006,0,1086,1086,1086,3002,1086,1086,0,0,1089,0
0,1089,0,0,1086,4007,0,0,4012,1086,0,0,1089,0,0,0,0,0,0,1087,0,0,0,0,0,0,0,0,0,3001,0,0,5004,0,0,3001,0,0,0,0,0,0,0,4009,0,1087,0,0,0,0,0,1089,0,0,1086,4002,0,0,4002,1086,0,0,1089,0
0,1089,2006,0,1086,0,5004,0,0,1086,0,0,1089,0,0,0,0,0,0,1087,1087,1087,1087,1087,1087,1087,1087,1087,1087,1087,0,0,0,0,0,1087,1087,1087,1087,1087,1087,1087,1087,1087,1087,1087,0,0,0,0,0,1089,0,0,1086,0,0,5004,0,1086,0,0,1089,0
0,1089,0,0,1086,0,0,0,0,1086,0,2005,1089,1089,1089,1089,1089,1089,1089,1089,1089,1089,1089,1089,1089,1089,1089,1089,1089,1089,1089,1089,1089,1089,1089,1089,1089,1089,1089,1089,1089,1089,1089,1089,1089,1089,1089,1089,1089,1089,1089,1089,0,0,1086,0,0,0,0,1086,0,0,1089,0
0,1089,0,0,1086,4002,4010,0,4002,1086,0,0,1089,5011,2036,0,0,0,0,0,0,0,0,0,0,0,0,0,0,0,2008,0,0,0,0,0,0,0,0,0,0,0,0,0,0,0,0,0,0,2034,0,1089,0,0,1086,4007,0,0,4012,1086,0,0,1089,0
0,1089,0,0,1086,1086,1086,1086,1086,1086,0,0,1089,0,2006,0,0,0,0,0,0,0,0,0,0,0,0,0,0,0,0,0,0,0,0,0,0,0,0,0,0,0,0,0,0,0,0,0,0,0,0,1089,0,0,1086,1086,1086,1086,1086,1086,0,2005,1089,0
0,1089,0,0,0,0,0,0,0,0,0,0,3001,0,0,0,0,5004,0,0,0,0,0,0,0,0,0,0,0,0,5004,0,0,0,0,0,0,0,0,0,0,0,0,0,0,5004,0,0,0,2005,0,3001,0,0,0,0,0,0,0,0,0,0,1089,0
0,1089,2033,0,0,0,2008,0,0,0,0,2035,1089,0,2033,0,0,0,0,0,0,0,0,0,0,0,0,0,0,0,2007,0,0,0,0,0,0,0,0,0,0,0,0,0,0,0,0,0,0,2035,0,1089,2033,0,0,2008,0,0,0,0,0,2035,1089,0
0,1089,1089,1089,1089,1089,1089,1089,1089,1089,1089,1089,1089,1089,1089,1089,1089,1089,1089,1089,1089,1089,1089,1089,1089,1089,1089,1089,1089,1089,1089,1089,1089,1089,1089,1089,1089,1089,1089,1089,1089,1089,1089,1089,1089,1089,1089,1089,1089,1089,1089,1089,1089,1089,1089,1089,1089,1089,1089,1089,1089,1089,1089,0
0,0,0,0,0,0,0,0,0,0,0,0,0,0,0,0,0,0,0,0,0,0,0,0,0,0,0,0,0,0,0,0,0,0,0,0,0,0,0,0,0,0,0,0,0,0,0,0,0,0,0,0,0,0,0,0,0,0,0,0,0,0,1089,0

0,0,0,0,0,0,0,0,0,0,0,0,0,0,0,0,0,0,0,0,0,0,0,0,0,0,0,0,0,0,0,0,0,0,0,0,0,0,0,0,0,0,0,0,0,0,0,0,0,0,0,0,0,0,0,0,0,0,0,0,0,0,0,0
0,0,0,0,0,0,0,0,0,0,0,0,0,0,0,0,0,0,0,0,0,0,0,0,0,0,0,0,0,0,0,0,0,0,0,0,0,0,0,0,0,0,0,0,0,0,0,0,0,0,0,0,0,0,0,0,0,0,0,0,0,0,0,0
0,0,9029,9029,9029,9029,9029,9029,9029,9029,9029,9029,0,9028,9028,9028,9028,9028,9028,9028,9028,9028,9028,9028,9028,9028,9028,9028,9028,9028,9028,9028,9028,9028,9028,9028,9028,9028,9028,9028,9028,9028,9028,9028,9028,9028,9028,9028,9028,9028,9028,0,9027,9027,9027,9027,9027,9027,9027,9027,9027,9027,0,0
0,0,9029,9029,9029,9029,9029,9029,9029,9029,9029,9029,0,9028,9028,9028,9028,9028,9028,9028,9028,9028,9028,9028,9028,9028,9028,9028,9028,9028,9028,9028,9028,9028,9028,9028,9028,9028,9028,9028,9028,9028,9028,9028,9028,9028,9028,9028,9028,9028,9028,0,9027,9027,9027,9027,9027,9027,9027,9027,9027,9027,0,0
0,0,9029,9029,0,0,0,0,0,0,9029,9029,0,9028,9028,9028,9028,9028,9028,9028,9028,9028,9028,9028,9028,9028,9028,9028,9028,9028,9028,9028,9028,9028,9028,9028,9028,9028,9028,9028,9028,9028,9028,9028,9028,9028,9028,9028,9028,9028,9028,0,9027,9027,0,0,0,0,0,0,9027,9027,0,0
0,0,9029,9029,0,9003,9003,9003,9003,0,9029,9029,0,9028,9028,9028,9028,9028,9028,9028,9028,9028,9028,9028,9028,9028,9028,9028,9028,9028,9028,9028,9028,9028,9028,9028,9028,9028,9028,9028,9028,9028,9028,9028,9028,9028,9028,9028,9028,9028,9028,0,9027,9027,0,9004,9004,9004,9004,0,9027,9027,0,0
0,0,9029,9029,0,9003,9003,9003,9003,0,9029,9029,0,0,0,0,0,0,0,0,0,0,0,0,0,0,0,0,0,0,0,0,0,0,0,0,0,0,0,0,0,0,0,0,0,0,0,0,0,0,0,0,9027,9027,0,9004,9004,9004,9004,0,9027,9027,0,0
0,0,9029,9029,0,9003,9003,9003,9003,0,9029,9029,0,0,0,0,0,0,0,0,0,0,0,0,0,9006,9006,9006,9006,9006,9006,9006,9006,9006,9006,9006,9006,9006,9006,9006,0,0,0,0,0,0,0,0,0,0,0,0,9027,9027,0,9004,9004,9004,9004,0,9027,9027,0,0
0,0,9029,9029,0,9003,9003,9003,9003,0,9029,9029,0,0,0,0,0,0,0,0,0,0,0,0,0,9006,9006,9006,0,0,0,9006,9006,9006,0,0,0,9006,9006,9006,0,0,0,0,0,0,0,0,0,0,0,0,9027,9027,0,9004,9004,9004,9004,0,9027,9027,0,0
0,0,9029,9029,0,0,0,0,0,0,9029,9029,0,0,0,0,0,0,0,0,0,0,0,0,0,9006,9006,9006,0,0,0,9006,9006,9006,0,0,0,9006,9006,9006,0,0,0,0,0,0,0,0,0,0,0,0,9027,9027,0,0,0,0,0,0,9027,9027,0,0
0,0,9029,9029,9029,9029,9029,9029,9029,9029,9029,9029,0,0,0,0,0,0,0,0,0,0,0,0,0,9006,9006,9006,0,0,0,9006,9006,9006,0,0,0,9006,9006,9006,0,0,0,0,0,0,0,0,0,0,0,0,9027,9027,9027,9027,9027,9027,9027,9027,9027,9027,0,0
0,0,9029,9029,9029,9029,9029,9029,9029,9029,9029,9029,0,0,0,0,0,0,0,0,0,0,0,0,0,9006,9006,9006,0,0,0,9006,9006,9006,0,0,0,9006,9006,9006,0,0,0,0,0,0,0,0,0,0,0,0,9027,9027,9027,9027,9027,9027,9027,9027,9027,9027,0,0
0,0,0,0,0,0,0,0,0,0,0,0,0,0,0,0,0,0,0,0,0,0,0,0,0,9006,9006,9006,0,0,0,9006,9006,9006,0,0,0,9006,9006,9006,0,0,0,0,0,0,0,0,0,0,0,0,0,0,0,0,0,0,0,0,0,0,0,0
0,0,9030,9030,9030,9030,0,0,0,0,0,0,0,0,0,0,0,0,0,0,0,0,0,0,0,9006,9006,9006,0,0,0,9006,9006,9006,0,0,0,9006,9006,9006,0,0,0,0,0,0,0,0,0,0,0,0,0,0,0,0,0,0,9026,9026,9026,9026,0,0
0,0,9030,9030,9030,9030,0,0,0,0,0,0,0,0,0,0,9006,9006,9006,9006,9006,9006,9006,9006,9006,9006,9006,9006,0,0,0,9006,9006,9006,0,0,0,9006,9006,9006,9006,9006,9006,9006,9006,9006,9006,9006,0,0,0,0,0,0,0,0,0,0,9026,9026,9026,9026,0,0
0,0,9030,9030,9030,9030,0,0,0,0,0,0,0,0,0,0,9006,9006,0,0,0,0,9006,9006,9006,9006,9006,9006,0,0,0,9006,9006,9006,0,0,0,9006,9006,9006,9006,9006,0,0,0,0,9006,9006,0,0,0,0,0,0,0,0,0,0,9026,9026,9026,9026,0,0
0,0,9030,9030,9030,9030,0,0,0,0,0,0,0,0,0,0,9006,9006,0,0,0,0,9006,9006,9006,9006,9006,9006,9006,9006,9006,9006,9006,9006,9006,9006,9006,9006,9006,9006,9006,9006,0,0,0,0,9006,9006,0,0,0,0,0,0,0,0,0,0,9026,9026,9026,9026,0,0
0,0,9030,9030,9030,9030,0,0,0,0,0,0,0,0,0,0,9006,9006,0,0,0,0,9006,9006,0,9006,9006,9006,9006,9006,9006,9006,9006,9006,9006,9006,9006,9006,9006,0,9006,9006,0,0,0,0,9006,9006,0,0,0,0,0,0,0,0,0,0,9026,9026,9026,9026,0,0
0,0,9030,9030,9030,9030,0,0,0,0,0,0,0,0,0,0,9006,9006,0,0,0,0,9006,9006,0,0,0,0,0,0,0,0,0,0,0,0,0,0,0,0,9006,9006,0,0,0,0,9006,9006,0,0,0,9024,0,9024,0,9024,0,0,9026,9026,9026,9026,0,0
0,0,9030,9030,9030,9030,0,0,0,0,0,0,0,0,0,0,9006,9006,0,0,0,0,9006,9006,9006,9006,9006,9006,9006,9006,9006,9006,9006,9006,9006,9006,9006,9006,9006,9006,9006,9006,0,0,0,0,9006,9006,0,0,0,9024,0,9024,0,9024,0,0,9026,9026,9026,9026,0,0
0,0,9030,9030,9030,9030,0,0,0,0,0,0,0,0,0,0,9006,9006,0,0,0,0,9006,9006,9006,9006,9006,9006,9006,9006,9006,9006,9006,9006,9006,9006,9006,9006,9006,9006,9006,9006,0,0,0,0,9006,9006,0,0,0,9024,0,9024,0,9024,0,0,9026,9026,9026,9026,0,0
0,0,9030,9030,9030,9030,0,0,0,0,0,0,0,0,0,0,9006,9006,0,0,0,0,9006,9006,9006,9006,9006,9006,9006,9006,9006,9006,9006,9006,9006,9006,9006,9006,9006,9006,9006,9006,0,0,0,0,9006,9006,0,0,0,0,0,0,0,0,0,0,9026,9026,9026,9026,0,0
0,0,9030,9030,9030,9030,0,0,0,0,0,0,0,0,0,0,9006,9006,9006,9006,9006,9006,9006,9006,9006,9006,9006,9006,9006,9006,9006,9006,9006,9006,9006,9006,9006,9006,9006,9006,9006,9006,9006,9006,9006,9006,9006,9006,0,0,0,9020,9020,9020,9020,9020,0,0,9026,9026,9026,9026,0,0
0,0,9030,9030,9030,9030,0,0,0,0,0,0,0,0,0,0,0,0,0,0,0,0,0,0,0,0,0,0,0,0,0,0,0,0,0,0,0,0,0,0,0,0,0,0,0,0,0,0,0,0,0,9020,9020,9020,9020,9020,0,0,9026,9026,9026,9026,0,0
0,0,9030,9030,9030,9030,0,0,0,0,0,0,0,0,0,0,0,0,0,0,0,0,0,9007,9007,9007,9007,9007,9007,9007,0,9023,9023,9023,0,9022,9022,9022,9022,9022,9022,0,0,0,0,0,0,0,0,0,0,9020,9020,9020,9020,9020,0,0,9026,9026,9026,9026,0,0
0,0,9030,9030,9030,9030,0,0,0,0,0,0,0,0,0,0,0,0,0,0,0,0,0,9007,9007,9007,9007,9007,9007,9007,0,9023,9023,9023,0,9022,9022,9022,9022,9022,9022,0,0,0,0,0,0,0,0,0,0,9020,9020,9020,9020,9020,0,0,9026,9026,9026,9026,0,0
0,0,9030,9030,9030,9030,0,0,0,0,0,0,0,0,0,0,0,0,0,0,0,0,0,9007,9007,9007,9007,9007,9007,9007,0,9023,9023,9023,0,9022,9022,9022,9022,9022,9022,0,0,0,0,0,0,0,0,0,0,9020,9020,9020,9020,9020,0,0,9026,9026,9026,9026,0,0
0,0,9030,9030,9030,9030,0,0,0,0,0,0,0,0,0,0,0,0,0,0,0,0,0,9007,9007,9007,9007,9007,9007,9007,0,0,0,0,0,9022,9022,9022,9022,9022,9022,0,0,0,0,0,0,0,0,0,0,9020,9020,9020,9020,9020,0,0,9026,9026,9026,9026,0,0
0,0,9030,9030,9030,9030,0,0,0,0,0,0,0,0,0,0,0,0,0,0,0,0,0,9007,9007,9007,9007,9007,9007,9007,0,0,0,0,0,9022,9022,9022,9022,9022,9022,0,0,0,0,0,0,0,0,0,0,9020,9020,9020,9020,9020,0,0,9026,9026,9026,9026,9017,0
0,0,9030,9030,9030,9030,0,0,0,0,0,0,0,0,0,0,0,0,0,0,0,0,0,0,0,0,0,0,0,0,0,0,0,0,0,0,0,0,0,0,0,0,0,0,0,0,0,0,0,0,0,9020,9020,9020,9020,9020,0,0,9026,9026,9026,9026,0,0
0,0,9030,9030,9030,9030,0,0,0,0,0,0,9009,9009,9009,9009,9009,0,9008,9008,9008,9008,9008,9008,9008,9008,9008,0,9021,9021,9021,9021,9021,9021,9021,9021,0,9019,9019,9019,9019,9019,9019,0,9020,9020,9020,9020,9020,9020,9020,9020,9020,9020,9020,9020,0,0,9026,9026,9026,9026,0,0
0,0,9030,9030,9030,9030,0,0,0,0,0,0,9009,9009,9009,9009,9009,0,9008,9008,9008,9008,9008,9008,9008,9008,9008,0,9021,9021,9021,9021,9021,9021,9021,9021,0,9019,9019,9019,9019,9019,9019,0,9020,9020,9020,9020,9020,9020,9020,9020,9020,9020,9020,9020,0,0,9026,9026,9026,9026,0,0
0,0,9030,9030,9030,9030,0,0,0,0,0,0,9009,9009,9009,9009,9009,0,9008,9008,9008,9008,9008,9008,9008,9008,9008,0,9021,9021,9021,9021,9021,9021,9021,9021,0,9019,9019,9019,9019,9019,9019,0,9020,9020,9020,9020,9020,9020,9020,9020,9020,9020,9020,9020,0,0,9026,9026,9026,9026,0,0
0,0,9030,9030,9030,9030,0,0,0,0,0,0,9009,9009,9009,9009,9009,0,9008,9008,9008,9008,9008,9008,9008,9008,9008,0,9021,9021,9021,9021,9021,9021,9021,9021,0,9019,9019,9019,9019,9019,9019,0,9020,9020,9020,9020,9020,9020,9020,9020,9020,9020,9020,9020,0,0,9026,9026,9026,9026,0,0
0,0,9030,9030,9030,9030,0,0,0,0,0,0,9009,9009,9009,9009,9009,0,0,0,0,0,0,0,0,0,0,0,0,0,0,0,0,0,0,0,0,0,0,0,0,0,0,0,0,0,0,0,0,0,0,0,0,0,0,0,0,0,9026,9026,9026,9026,0,0
0,0,9030,9030,9030,9030,0,0,0,0,0,0,9009,9009,9009,9009,9009,0,0,0,9011,9011,9011,9011,9011,9011,9011,9011,9011,9011,9011,0,9018,9018,9018,9018,9018,9018,9018,9018,9018,9018,0,0,0,0,0,0,0,0,0,0,0,0,0,0,0,0,9026,9026,9026,9026,0,0
0,0,9030,9030,9030,9030,0,0,0,0,0,0,9009,9009,9009,9009,9009,0,0,0,9011,9011,9011,9011,9011,9011,9011,9011,9011,9011,9011,0,9018,9018,9018,9018,9018,9018,9018,9018,9018,9018,9018,9018,0,0,0,0,0,0,0,0,0,0,0,0,0,0,9026,9026,9026,9026,0,0
0,0,9030,9030,9030,9030,0,0,0,0,0,0,9009,9009,9009,9009,9009,0,0,0,9011,9011,9011,9011,9011,9011,9011,9011,9011,9011,9011,0,9018,9018,9018,9018,9018,9018,9018,9018,9018,9018,9018,0,0,0,0,0,0,0,0,0,0,0,0,0,0,0,9026,9026,9026,9026,0,0
0,0,9030,9030,9030,9030,0,0,0,0,0,0,9009,9009,9009,9009,9009,0,0,0,9011,9011,9011,9011,9011,9011,9011,9011,9011,9011,9011,0,9018,9018,9018,9018,9018,9018,9018,9018,9018,9018,9018,9017,0,0,0,0,0,0,0,0,0,0,0,0,0,0,9026,9026,9026,9026,0,0
0,0,9030,9030,9030,9030,0,0,0,0,0,0,9009,9009,9009,9009,9009,0,0,0,9011,9011,9011,9011,9011,9011,9011,9011,9011,9011,9011,0,9018,9018,9018,9018,9018,9018,9018,9018,9018,9018,9018,0,0,0,0,0,0,0,0,0,0,0,0,0,0,0,9026,9026,9026,9026,0,0
0,0,9030,9030,9030,9030,0,0,0,0,0,0,9009,9009,9009,9009,9009,0,0,0,0,0,0,0,0,0,0,0,0,0,0,0,0,0,0,0,0,0,0,0,0,9017,0,0,0,0,0,0,0,0,0,0,0,0,0,0,0,0,9026,9026,9026,9026,0,0
0,0,9030,9030,9030,9030,0,0,0,0,0,0,0,0,0,0,0,0,0,0,0,0,9012,9012,9012,0,0,0,0,0,0,0,0,0,0,0,0,0,9017,9017,9017,0,0,0,0,0,0,0,0,0,0,0,0,0,0,0,0,0,9026,9026,9026,9026,0,0
0,0,9030,9030,9030,9030,0,0,0,0,0,0,9010,0,9010,0,9010,0,0,0,9012,9012,9012,9012,9012,9012,9012,0,9015,9015,9015,9015,9015,9015,9015,0,9017,9017,9017,9017,9017,9017,9017,0,0,0,0,0,0,0,0,0,0,0,0,0,0,0,9026,9026,9026,9026,0,0
0,0,9030,9030,9030,9030,0,0,0,0,0,0,9010,0,9010,0,9010,0,0,0,9012,9012,9012,9012,9012,9012,9012,0,9015,9015,9015,9015,9015,9015,9015,0,9017,9017,9017,9017,9017,9017,9017,0,0,0,0,0,0,0,0,0,0,0,0,0,0,0,9026,9026,9026,9026,0,0
0,0,9030,9030,9030,9030,0,0,0,0,0,0,9010,0,9010,0,9010,0,0,0,9012,9012,9012,9012,9012,9012,9012,0,0,0,0,0,0,0,0,0,9017,9017,9017,9017,9017,9017,9017,0,0,0,0,0,0,0,0,0,0,0,0,0,0,0,9026,9026,9026,9026,0,0
0,0,9030,9030,9030,9030,0,0,0,0,0,0,9010,0,9010,0,9010,0,0,0,9012,9012,9012,9012,9012,9012,9012,0,9014,9014,9014,9014,9014,9014,9014,0,9017,9017,9017,9017,9017,9017,9017,0,0,0,0,0,0,0,0,0,0,0,0,0,0,0,9026,9026,9026,9026,0,0
0,0,9030,9030,9030,9030,0,0,0,0,0,0,0,0,0,0,0,0,0,0,9012,9012,9012,9012,9012,9012,9012,0,9014,9014,9014,9014,9014,9014,9014,0,9017,9017,9017,9017,9017,9017,9017,0,0,0,0,0,0,0,0,0,0,0,0,0,0,0,9026,9026,9026,9026,0,0
0,0,9030,9030,9030,9030,0,0,0,0,0,0,0,0,0,0,0,0,0,0,9012,9012,9012,9012,9012,9012,9012,0,9014,9014,9014,9014,9014,9014,9014,0,9017,9017,9017,9017,9017,9017,9017,0,0,0,0,0,0,0,0,0,0,0,0,0,0,0,9026,9026,9026,9026,0,0
0,0,9030,9030,9030,9030,0,0,0,0,0,0,0,0,0,0,0,0,0,0,9012,9012,9012,9012,9012,9012,9012,0,9014,9014,9014,9014,9014,9014,9014,0,9017,9017,9017,9017,9017,9017,9017,0,0,0,0,0,0,0,0,0,0,0,0,0,0,0,9026,9026,9026,9026,0,0
0,0,9030,9030,9030,9030,0,0,0,0,0,0,0,0,0,0,0,0,0,0,9012,9012,9012,9012,9012,9012,9012,0,9014,9014,9014,9014,9014,9014,9014,0,9017,9017,9017,9017,9017,9017,9017,0,0,0,0,0,0,0,0,0,0,0,0,0,0,0,9026,9026,9026,9026,0,0
0,0,9030,9030,9030,9030,0,0,0,0,0,0,0,0,0,0,0,0,0,0,9012,9012,9012,9012,9012,9012,9012,0,9014,9014,9014,9014,9014,9014,9014,0,9017,9017,9017,9017,9017,9017,9017,0,0,0,0,0,0,0,0,0,0,0,0,0,0,0,9026,9026,9026,9026,0,0
0,0,9030,0,0,0,0,0,0,0,0,0,0,0,0,0,0,0,0,0,9012,9012,9012,9012,9012,9012,9012,0,9014,9014,9014,9014,9014,9014,9014,0,9017,9017,9017,9017,9017,9017,9017,0,0,0,0,0,0,0,0,0,0,0,0,0,0,0,0,0,0,0,0,0
0,0,9001,9001,9001,9001,9001,9001,9001,9001,9001,9001,0,0,0,0,0,0,0,0,9012,9012,9012,9012,9012,9012,9012,0,9014,9014,9014,9014,9014,9014,9014,0,9017,9017,9017,9017,9017,9017,9017,0,0,0,0,0,0,0,0,0,9025,9025,9025,9025,9025,9025,9025,9025,9025,9025,0,0
0,0,9001,9001,9001,9001,9001,9001,9001,9001,9001,9001,0,0,0,0,0,0,0,0,0,0,0,0,0,0,0,0,0,0,9014,9014,9014,9014,9014,0,0,0,0,0,0,0,0,0,0,0,0,0,0,0,0,0,9025,9025,9025,9025,9025,9025,9025,9025,9025,9025,0,0
0,0,9001,9001,0,0,0,0,0,0,9001,9001,0,0,0,0,0,0,0,0,9013,9013,9013,9013,9013,9013,9013,9013,9013,0,9014,9014,9014,9014,9014,0,9016,9016,9016,9016,9016,9016,9016,9016,9016,0,0,0,0,0,0,0,9025,9025,0,0,0,0,0,0,9025,9025,0,0
0,0,9001,9001,0,9002,9002,9002,9002,0,9001,9001,0,0,0,0,0,0,0,0,9013,9013,9013,9013,9013,9013,9013,9013,9013,0,9014,9014,9014,9014,9014,0,9016,9016,9016,9016,9016,9016,9016,9016,9016,0,0,0,0,0,0,0,9025,9025,0,9005,9005,9005,9005,0,9025,9025,0,0
0,0,9001,9001,0,9002,9002,9002,9002,0,9001,9001,0,0,0,0,0,0,0,0,0,0,0,0,0,0,0,0,0,0,9014,9014,9014,9014,9014,0,0,0,0,0,0,0,0,0,0,0,0,0,0,0,0,0,9025,9025,0,9005,9005,9005,9005,0,9025,9025,0,0
0,0,9001,9001,0,9002,9002,9002,9002,0,9001,9001,0,0,0,0,0,0,0,0,0,0,0,0,0,0,0,0,0,0,0,0,0,0,0,0,0,0,0,0,0,0,0,0,0,0,0,0,0,0,0,0,9025,9025,0,9005,9005,9005,9005,0,9025,9025,0,0
0,0,9001,9001,0,9002,9002,9002,9002,0,9001,9001,0,9024,9024,9024,9024,9024,9024,9024,9024,9024,9024,9024,9024,9024,9024,9024,9024,9024,9024,9024,9024,9024,9024,9024,9024,9024,9024,9024,9024,9024,9024,9024,9024,9024,9024,9024,9024,9024,9024,0,9025,9025,0,9005,9005,9005,9005,0,9025,9025,0,0
0,0,9001,9001,0,0,0,0,0,0,9001,9001,0,9024,9024,9024,9024,9024,9024,9024,9024,9024,9024,9024,9024,9024,9024,9024,9024,9024,9024,9024,9024,9024,9024,9024,9024,9024,9024,9024,9024,9024,9024,9024,9024,9024,9024,9024,9024,9024,9024,0,9025,9025,0,0,0,0,0,0,9025,9025,0,0
0,0,9001,9001,9001,9001,9001,9001,9001,9001,9001,9001,0,9024,9024,9024,9024,9024,9024,9024,9024,9024,9024,9024,9024,9024,9024,9024,9024,9024,9024,9024,9024,9024,9024,9024,9024,9024,9024,9024,9024,9024,9024,9024,9024,9024,9024,9024,9024,9024,9024,0,9025,9025,9025,9025,9025,9025,9025,9025,9025,9025,0,0
0,0,9001,9001,9001,9001,9001,9001,9001,9001,9001,9001,0,9024,9024,9024,9024,9024,9024,9024,9024,9024,9024,9024,9024,9024,9024,9024,9024,9024,9024,9024,9024,9024,9024,9024,9024,9024,9024,9024,9024,9024,9024,9024,9024,9024,9024,9024,9024,9024,9024,0,9025,9025,9025,9025,9025,9025,9025,9025,9025,9025,0,0
0,0,0,0,0,0,0,0,0,0,0,0,0,0,0,0,0,0,0,0,0,0,0,0,0,0,0,0,0,0,0,0,0,0,0,0,0,0,0,0,0,0,0,0,0,0,0,0,0,0,0,0,0,0,0,0,0,0,0,0,0,0,0,0
0,0,0,0,0,0,0,0,0,0,0,0,0,0,0,0,0,0,0,0,0,0,0,0,0,0,0,0,0,0,0,0,0,0,0,0,0,0,0,0,0,0,0,0,0,0,0,0,0,0,0,0,0,0,0,0,0,0,0,0,0,0,0,0
