64
1037
1040
0,0,0,0,0,0,0,0,0,0,0,0,0,0,0,0,0,0,0,0,0,0,0,0,0,0,0,0,0,0,0,0,0,0,0,0,0,0,0,0,0,0,0,0,0,0,0,0,0,0,0,0,0,0,0,0,0,0,0,0,0,0,0,0
0,0,0,0,0,0,0,0,0,0,0,0,0,0,0,0,0,0,0,0,0,0,0,0,0,0,0,0,0,0,0,0,0,0,0,0,0,0,0,0,0,0,0,0,0,0,0,0,0,0,0,0,0,0,0,0,0,0,0,0,0,0,0,0
0,0,0,0,0,0,0,0,0,0,0,0,0,0,0,0,0,0,0,0,0,0,0,0,0,0,0,0,0,0,0,0,0,0,0,0,0,0,0,0,0,0,0,0,0,0,0,0,0,0,0,0,0,0,0,0,0,0,0,0,0,0,0,0
0,0,0,0,0,0,0,0,0,0,0,0,0,0,0,0,0,0,0,0,0,0,0,0,0,0,0,0,0,0,0,0,0,0,0,0,0,0,0,0,0,0,0,0,0,0,0,0,0,0,0,0,0,0,0,0,0,0,0,0,0,0,0,0
0,0,0,0,0,0,0,0,0,0,0,0,0,0,0,0,0,0,0,0,0,0,0,0,0,0,0,0,0,0,0,0,0,0,0,0,0,0,0,0,0,0,0,0,0,0,0,0,0,0,0,0,0,0,0,0,0,0,0,0,0,0,0,0
0,0,0,0,0,0,0,0,0,0,0,0,0,0,0,0,0,0,0,0,0,0,0,0,0,0,0,0,0,0,0,0,0,0,0,0,0,0,0,0,0,0,0,0,0,0,0,0,0,0,0,0,0,0,0,0,0,0,0,0,0,0,0,0
0,0,0,0,0,0,0,0,0,0,0,0,0,0,0,0,0,0,0,0,0,0,0,0,0,0,0,0,0,0,0,0,0,0,0,0,0,0,0,0,0,0,0,0,0,0,0,0,0,0,0,0,0,0,0,0,0,0,0,0,0,0,0,0
0,0,0,0,0,0,0,0,0,0,0,0,0,0,0,0,0,0,0,0,0,0,0,0,0,0,0,0,0,0,0,0,0,0,0,0,0,0,0,0,0,0,0,0,0,0,0,0,0,0,0,0,0,0,0,0,0,0,0,0,0,0,0,0
0,0,0,0,0,0,0,0,0,0,0,0,0,0,0,0,0,0,0,0,0,0,0,0,0,0,0,0,0,0,0,0,0,0,0,0,0,0,0,0,0,0,0,0,0,0,0,0,0,0,0,0,0,0,0,0,0,0,0,0,0,0,0,0
0,0,0,0,0,0,0,0,0,0,0,0,0,0,0,0,0,0,0,0,0,0,0,0,1028,1028,1028,1028,1028,1028,1028,1028,1028,1028,1028,1028,0,0,0,0,0,0,0,0,0,0,0,0,0,0,0,0,0,0,0,0,0,0,0,0,0,0,0,0
0,0,0,0,0,0,0,0,0,0,0,0,0,0,1028,1028,1028,1028,1028,1028,1028,1028,1028,1028,1028,5003,0,0,0,0,5010,0,0,0,5003,1028,1028,1028,1028,1028,1028,1028,1028,0,0,0,0,0,0,0,0,0,0,0,0,0,0,0,0,0,0,0,0,0
0,0,0,0,0,0,0,0,0,0,0,0,0,0,1028,0,0,0,0,0,0,0,0,0,1028,0,0,0,0,0,0,0,0,0,0,1028,2036,0,0,4007,0,2034,1028,0,0,0,0,0,0,0,0,0,0,0,0,0,0,0,0,0,0,0,0,0
0,0,0,0,0,0,0,0,0,0,0,0,0,0,1028,0,2033,5004,0,0,0,2007,2034,0,3001,0,0,5004,0,0,5013,0,5004,0,0,3001,0,2033,0,5004,2036,2005,1028,0,0,0,0,0,0,0,0,0,0,0,0,0,0,0,0,0,0,0,0,0
0,0,0,0,0,0,0,0,0,0,0,0,0,0,1028,0,0,0,0,0,0,0,0,0,1028,0,0,0,0,0,0,0,0,0,0,1028,0,2035,2008,0,2034,0,1028,0,0,0,0,0,0,0,0,0,0,0,0,0,0,0,0,0,0,0,0,0
0,0,0,0,0,0,0,0,0,0,0,0,0,0,1028,0,0,0,0,1028,1028,1028,1028,1028,1028,5003,0,0,0,0,0,0,0,0,5003,1028,2033,0,0,4002,0,2035,1028,0,0,0,0,0,0,0,0,0,0,0,0,0,0,0,0,0,0,0,0,0
0,0,0,0,0,0,0,0,0,0,0,0,0,0,1028,0,0,0,0,1028,0,0,0,0,1028,1028,1028,1028,0,0,0,0,1028,1028,1028,1028,1028,1028,1028,1028,1028,1028,1028,0,0,0,0,0,0,0,0,0,0,0,0,0,0,0,0,0,0,0,0,0
0,0,0,0,0,0,0,0,0,0,0,0,0,0,1028,0,0,5004,0,1028,0,0,0,0,0,0,0,1028,1028,1028,3002,1028,1028,0,0,0,0,0,0,0,0,0,0,0,0,0,0,0,0,0,0,0,0,0,0,0,0,0,0,0,0,0,0,0
0,0,0,0,0,0,0,0,0,0,0,0,0,0,1028,0,0,0,0,1028,0,0,0,0,0,0,0,0,1028,5003,0,5003,1028,0,0,0,0,0,0,0,0,0,0,0,0,0,0,0,0,0,0,0,0,0,0,0,0,0,0,0,0,0,0,0
0,0,0,0,0,0,0,0,0,0,0,0,0,0,1028,0,0,0,0,1028,0,0,0,0,0,0,0,0,1028,0,0,0,1028,0,0,0,0,0,0,0,0,0,0,0,0,0,0,0,0,0,0,0,0,0,0,0,0,0,0,0,0,0,0,0
0,1028,1028,1028,1028,1028,1028,1028,1028,1028,1028,1028,1028,1028,1028,0,0,0,0,1028,1028,1028,1028,0,0,0,0,0,1028,0,5004,0,1028,0,0,0,0,0,0,0,0,0,0,0,0,0,0,0,0,0,0,0,0,0,0,0,0,0,0,0,0,0,0,0
0,1028,5009,0,0,4002,1028,5014,0,0,0,0,1028,5014,0,0,0,0,0,0,0,2004,1028,0,0,0,1028,1028,1028,0,0,0,1028,1028,1028,0,0,0,0,0,0,0,0,0,0,0,0,0,0,0,0,0,0,0,0,0,0,0,0,0,0,0,0,0
0,1028,2001,0,0,0,1028,2004,0,0,0,0,3001,0,0,0,0,5004,0,0,0,0,1028,0,0,0,1028,2003,5007,0,0,0,4007,4001,1028,0,0,0,0,0,0,0,0,0,0,0,0,0,0,0,0,0,0,0,0,0,0,0,0,0,0,0,0,0
0,1028,0,5004,0,0,1028,0,0,5004,0,0,1028,5014,0,0,0,0,0,0,0,5013,1028,0,0,0,1028,1028,1028,0,0,0,1028,1028,1028,0,0,0,0,0,0,0,0,0,0,0,0,0,0,0,0,0,0,0,0,0,0,0,0,0,0,0,0,0
0,1028,0,0,0,0,1028,0,0,0,0,5014,1028,1028,1028,1028,1028,1028,1028,1028,1028,1028,1028,0,0,0,0,0,1028,0,5004,0,1028,0,0,0,0,0,0,0,0,0,0,0,0,0,0,0,0,0,0,0,0,0,0,0,0,0,0,0,0,0,0,0
0,1028,1028,3002,1028,1028,1028,1028,3002,1028,1028,1028,1028,0,0,0,0,0,0,0,0,0,0,0,0,0,0,0,1028,0,0,0,1028,0,0,0,0,0,0,0,0,0,0,0,0,0,0,0,0,0,0,0,0,0,0,0,0,0,0,0,0,0,0,0
0,1030,5006,0,0,0,1030,4007,0,0,1030,0,0,0,0,0,0,0,0,0,0,0,0,0,0,0,0,0,1028,0,0,0,1028,0,0,0,0,0,0,0,0,0,0,0,0,0,0,0,0,0,0,0,0,0,0,0,0,0,0,0,0,0,0,0
0,1030,0,0,0,0,1030,0,0,0,1030,0,0,0,0,0,0,0,0,0,0,0,0,1002,1002,1002,1002,1002,1002,1002,3002,1002,1002,1002,1002,1002,1002,1002,1002,0,0,0,0,0,1002,1002,1002,1002,1002,1002,1002,1002,1002,1002,0,0,0,0,0,0,0,0,0,0
0,1030,0,0,0,0,1030,0,5004,0,1030,0,0,0,0,0,0,0,0,0,0,0,0,1002,5006,0,0,0,0,0,0,0,0,0,0,0,0,5006,1002,0,0,0,0,0,1002,5011,0,0,0,0,0,4007,4002,1002,0,0,0,0,0,0,0,0,0,0
0,1030,0,0,0,0,1030,0,0,0,1030,0,0,0,0,0,0,0,0,0,0,0,0,1002,0,0,0,0,0,0,0,0,0,0,0,0,0,0,1002,1002,1002,1002,1002,1002,1002,0,2036,0,0,0,0,2034,0,1002,0,0,0,0,0,0,0,0,0,0
0,1030,0,5004,0,0,1030,1030,3002,1030,1030,1030,1030,1030,1030,1030,1030,1030,1030,0,0,0,0,1002,0,0,0,0,0,0,0,0,0,0,0,0,0,0,1002,0,0,0,0,0,3001,0,0,0,0,0,0,0,0,1002,0,0,0,0,0,0,0,0,0,0
0,1030,0,0,0,0,1030,0,0,0,0,0,0,0,0,0,0,5014,1030,0,0,0,0,1002,0,2033,0,0,5004,0,0,0,5004,0,0,2008,2034,0,3001,0,0,0,5004,0,1002,0,0,1000,0,0,0,0,5005,1002,0,0,0,0,0,0,0,0,0,0
0,1030,0,0,0,0,1030,0,0,0,0,0,0,0,0,0,0,0,1030,0,0,0,0,1002,0,0,0,0,0,0,0,0,0,0,0,0,0,0,1002,0,0,0,0,0,1002,0,0,0,5004,0,0,0,5005,1002,0,0,0,0,0,0,0,0,0,0
0,1030,0,2036,0,0,3001,0,2034,0,5004,0,0,0,0,5004,0,2008,1030,0,0,0,0,1002,0,0,0,0,0,0,0,0,0,0,0,0,0,0,1002,1002,1002,0,0,0,1002,2001,0,0,0,0,0,2005,5005,1002,0,0,0,0,0,0,0,0,0,0
0,1030,0,0,0,0,1030,0,0,0,0,0,0,0,0,0,0,0,1030,0,0,0,0,1002,5006,0,0,0,0,0,1000,0,0,0,0,0,0,5006,1002,0,1002,0,0,0,1002,0,2033,0,0,0,0,2035,5005,1002,0,0,0,0,0,0,0,0,0,0
0,1030,0,2006,0,0,1030,0,0,2001,0,0,0,0,0,0,0,5014,1030,0,0,0,0,1002,1002,1002,1002,1002,1002,1002,3002,1002,1002,1002,1002,1002,1002,1002,1002,0,1002,0,5007,0,1002,0,0,0,0,0,0,0,5005,1002,0,0,0,0,0,0,0,0,0,0
0,1030,0,0,0,0,1030,1030,3002,1030,1030,1030,1030,1030,1030,1030,1030,1030,1030,0,0,0,0,0,0,0,0,0,1002,5002,0,5002,1002,0,0,0,0,0,0,0,1002,0,0,0,1002,1002,1002,1002,1002,1002,1002,1002,1002,1002,0,0,0,0,0,0,0,0,0,0
0,1030,0,0,0,0,1030,0,0,0,1030,0,0,0,0,0,0,0,0,0,0,0,0,0,0,0,0,0,1002,0,3000,0,1002,0,0,0,0,0,0,0,1002,0,0,0,1002,0,0,0,0,0,0,0,4007,1002,0,0,0,0,0,0,0,0,0,0
0,1030,0,0,0,0,1030,0,0,0,1030,0,0,0,0,0,0,0,0,0,0,0,0,0,0,0,0,0,1002,0,0,0,1002,0,0,0,0,0,0,0,1002,0,5004,0,1002,0,2036,0,0,0,0,2034,0,1002,0,0,0,0,0,0,0,0,0,0
0,1030,0,0,0,0,1030,0,5004,0,1030,0,0,0,0,0,0,0,0,0,0,0,0,0,0,0,0,0,1002,0,2002,0,1002,0,0,0,0,0,0,0,1002,0,0,0,3001,0,0,0,5013,5004,0,0,0,1002,0,0,0,0,0,0,0,0,0,0
0,1030,0,5004,0,0,1030,0,0,0,1030,0,0,0,0,0,0,0,0,0,0,0,0,0,0,0,0,0,1002,0,0,0,1002,0,0,0,0,0,0,0,1002,0,0,0,1002,0,2033,0,0,0,2007,2035,0,1002,0,0,0,0,0,0,0,0,0,0
0,1030,0,0,0,0,1030,1030,3002,1030,1030,1030,1030,1030,1030,1030,0,0,0,0,0,0,0,0,0,0,0,0,1002,0,0,0,1002,0,0,0,0,0,0,0,1002,0,2001,0,1002,0,0,0,0,0,0,0,0,1002,0,0,0,0,0,0,0,0,0,0
0,1030,0,0,0,0,0,0,0,0,0,0,0,0,0,1030,1030,1030,1030,1030,1030,1030,0,0,0,0,0,0,1002,0,5004,0,1002,0,0,0,0,0,0,0,1002,1002,1002,1002,1002,1002,1002,1002,1002,1002,1002,1002,1002,1002,0,0,0,0,0,0,0,0,0,0
0,1030,0,0,0,0,0,0,2005,0,0,0,0,0,2004,1030,0,0,1012,1012,1012,1030,0,0,0,0,0,0,1002,0,0,0,1002,0,0,0,0,0,0,0,0,0,0,0,0,0,0,0,0,0,0,0,0,0,0,0,0,0,0,0,0,0,0,0
0,1030,0,2033,0,0,5004,0,2035,0,0,5004,0,0,0,3001,0,5004,3001,4011,1012,1030,0,0,0,0,0,0,1002,0,0,0,1002,0,0,0,0,0,0,0,0,0,0,0,0,0,0,0,0,0,0,0,0,0,0,0,0,0,0,0,0,0,0,0
0,1030,5006,0,0,0,0,0,0,0,0,0,0,0,2004,1030,0,0,1012,1012,1012,1030,0,0,0,0,0,0,1002,0,0,0,1002,0,0,0,0,0,0,0,0,0,0,0,0,0,0,0,0,0,0,0,0,0,0,0,0,0,0,0,0,0,0,0
0,1030,1030,1030,1030,1030,1030,1030,1030,1030,1030,1030,1030,1030,1030,1030,1030,1030,1030,1030,1030,1030,0,0,0,0,0,0,1001,1001,3002,1001,1001,0,0,0,0,0,0,0,0,0,0,0,0,0,0,0,0,0,0,0,0,0,0,0,0,0,0,0,0,0,0,0
0,0,0,0,0,0,0,0,0,0,0,0,0,0,0,0,0,0,0,0,0,0,1001,1001,1001,1001,1001,1001,1001,0,0,0,1001,1001,1001,1001,1001,1001,0,0,0,0,0,0,0,0,0,0,0,0,0,0,0,0,0,0,0,0,0,0,0,0,0,0
0,0,0,0,0,0,0,0,0,0,0,0,0,0,0,0,0,0,0,0,0,0,1001,0,0,0,0,0,1001,0,5007,0,1001,0,0,0,0,1001,0,0,0,0,0,0,0,0,0,0,0,0,0,0,0,0,0,0,0,0,0,0,0,0,0,0
0,0,0,0,0,0,0,0,0,0,0,0,0,0,0,0,0,0,0,0,0,0,1001,4001,0,5001,0,0,3001,0,0,0,3001,0,5001,0,4001,1001,0,0,0,0,0,0,0,0,0,0,0,0,0,0,0,0,0,0,0,0,0,0,0,0,0,0
0,0,0,0,0,0,0,0,0,0,0,0,0,0,0,0,0,0,0,0,0,0,1001,0,0,0,0,0,1001,0,0,0,1001,0,0,0,0,1001,0,0,0,0,0,0,0,0,0,0,0,0,0,0,0,0,0,0,0,0,0,0,0,0,0,0
0,0,0,0,0,0,0,0,0,0,0,0,0,0,0,0,0,0,0,0,0,0,1001,1001,1001,1001,1001,1001,1001,0,0,0,1001,1001,1001,1001,1001,1001,0,0,0,0,0,0,0,0,0,0,0,0,0,0,0,0,0,0,0,0,0,0,0,0,0,0
0,0,0,0,0,0,0,0,0,0,0,0,0,0,0,0,0,0,0,0,0,0,1001,0,0,0,0,5001,1001,0,0,0,1001,0,0,0,0,1001,0,0,0,0,0,0,0,0,0,0,0,0,0,0,0,0,0,0,0,0,0,0,0,0,0,0
0,0,0,0,0,0,0,0,0,0,0,0,0,0,0,0,0,0,0,0,0,0,1001,4010,0,5004,0,0,3001,0,5004,0,3001,0,5001,0,2004,1001,0,0,0,0,0,0,0,0,0,0,0,0,0,0,0,0,0,0,0,0,0,0,0,0,0,0
0,0,0,0,0,0,0,0,0,0,0,0,0,0,0,0,0,0,0,0,0,0,1001,0,0,0,0,0,1001,0,0,0,1001,0,0,0,4007,1001,0,0,0,0,0,0,0,0,0,0,0,0,0,0,0,0,0,0,0,0,0,0,0,0,0,0
0,0,0,0,0,0,0,0,0,0,0,0,0,0,0,0,0,0,0,0,0,0,1001,1001,1001,1001,1001,1001,1001,0,0,0,1001,1001,1001,1001,1001,1001,0,0,0,0,0,0,0,0,0,0,0,0,0,0,0,0,0,0,0,0,0,0,0,0,0,0
0,0,0,0,0,0,0,0,0,0,0,0,0,0,0,0,0,0,0,0,0,0,1001,2003,0,0,0,0,0,0,0,0,0,0,0,0,0,1001,0,0,0,0,0,0,0,0,0,0,0,0,0,0,0,0,0,0,0,0,0,0,0,0,0,0
0,0,0,0,0,0,0,0,0,0,0,0,0,0,0,0,0,0,0,0,0,0,1001,0,0,5004,0,0,0,0,0,0,0,0,5004,0,0,1001,0,0,0,0,0,0,0,0,0,0,0,0,0,0,0,0,0,0,0,0,0,0,0,0,0,0
0,0,0,0,0,0,0,0,0,0,0,0,0,0,0,0,0,0,0,0,0,0,1001,0,0,0,0,0,5007,0,0,0,0,0,0,0,0,1001,0,0,0,0,0,0,0,0,0,0,0,0,0,0,0,0,0,0,0,0,0,0,0,0,0,0
0,0,0,0,0,0,0,0,0,0,0,0,0,0,0,0,0,0,0,0,0,0,1001,5003,0,0,0,0,0,0,0,0,0,0,0,0,5003,1001,0,0,0,0,0,0,0,0,0,0,0,0,0,0,0,0,0,0,0,0,0,0,0,0,0,0
0,0,0,0,0,0,0,0,0,0,0,0,0,0,0,0,0,0,0,0,0,0,1001,1001,1001,1001,1001,1001,1001,1001,1001,1001,1001,1001,1001,1001,1001,1001,0,0,0,0,0,0,0,0,0,0,0,0,0,0,0,0,0,0,0,0,0,0,0,0,0,0
0,0,0,0,0,0,0,0,0,0,0,0,0,0,0,0,0,0,0,0,0,0,0,0,0,0,0,0,0,0,0,0,0,0,0,0,0,0,0,0,0,0,0,0,0,0,0,0,0,0,0,0,0,0,0,0,0,0,0,0,0,0,0,0
0,0,0,0,0,0,0,0,0,0,0,0,0,0,0,0,0,0,0,0,0,0,0,0,0,0,0,0,0,0,0,0,0,0,0,0,0,0,0,0,0,0,0,0,0,0,0,0,0,0,0,0,0,0,0,0,0,0,0,0,0,0,0,0
0,0,0,0,0,0,0,0,0,0,0,0,0,0,0,0,0,0,0,0,0,0,0,0,0,0,0,0,0,0,0,0,0,0,0,0,0,0,0,0,0,0,0,0,0,0,0,0,0,0,0,0,0,0,0,0,0,0,0,0,0,0,0,0
0,0,0,0,0,0,0,0,0,0,0,0,0,0,0,0,0,0,0,0,0,0,0,0,0,0,0,0,0,0,0,0,0,0,0,0,0,0,0,0,0,0,0,0,0,0,0,0,0,0,0,0,0,0,0,0,0,0,0,0,0,0,0,0

0,0,0,0,0,0,0,0,0,0,0,0,0,0,0,0,0,0,0,0,0,0,0,0,0,0,0,0,0,0,0,0,0,0,0,0,0,0,0,0,0,0,0,0,0,0,0,0,0,0,0,0,0,0,0,0,0,0,0,0,0,0,0,0
0,0,0,0,0,0,0,0,0,0,0,0,0,0,0,0,0,0,0,0,0,0,0,0,0,0,0,0,0,0,0,0,0,0,0,0,0,0,0,0,0,0,0,0,0,0,0,0,0,0,0,0,0,0,0,0,0,0,0,0,0,0,0,0
0,0,0,0,0,0,0,0,0,0,0,0,0,0,0,0,0,0,0,0,0,0,0,0,0,0,0,0,0,0,0,0,0,0,0,0,0,0,0,0,0,0,0,0,0,0,0,0,0,0,0,0,0,0,0,0,0,0,0,0,0,0,0,0
0,0,0,0,0,0,0,0,0,0,0,0,0,0,0,0,0,0,0,0,0,0,0,0,0,0,0,0,0,0,0,0,0,0,0,0,0,0,0,0,0,0,0,0,0,0,0,0,0,0,0,0,0,0,0,0,0,0,0,0,0,0,0,0
0,0,0,0,0,0,0,0,0,0,0,0,0,0,0,0,0,0,0,0,0,0,0,0,0,0,0,0,0,0,0,0,0,0,0,0,0,0,0,0,0,0,0,0,0,0,0,0,0,0,0,0,0,0,0,0,0,0,0,0,0,0,0,0
0,0,0,0,0,0,0,0,0,0,0,0,0,0,0,0,0,0,0,0,0,0,0,0,0,0,0,0,0,0,0,0,0,0,0,0,0,0,0,0,0,0,0,0,0,0,0,0,0,0,0,0,0,0,0,0,0,0,0,0,0,0,0,0
0,0,0,0,0,0,0,0,0,0,0,0,0,0,0,0,0,0,0,0,0,0,0,0,0,0,0,0,0,0,0,0,0,0,0,0,0,0,0,0,0,0,0,0,0,0,0,0,0,0,0,0,0,0,0,0,0,0,0,0,0,0,0,0
0,0,0,0,0,0,0,0,0,0,0,0,0,0,0,0,0,0,0,0,0,0,0,0,0,0,0,0,0,0,0,0,0,0,0,0,0,0,0,0,0,0,0,0,0,0,0,0,0,0,0,0,0,0,0,0,0,0,0,0,0,0,0,0
0,0,0,0,0,0,0,0,0,0,0,0,0,0,0,0,0,0,0,0,0,0,0,0,0,0,0,0,0,0,0,0,0,0,0,0,0,0,0,0,0,0,0,0,0,0,0,0,0,0,0,0,0,0,0,0,0,0,0,0,0,0,0,0
0,0,0,0,0,0,0,0,0,0,0,0,0,0,0,0,0,0,0,0,0,0,0,0,0,0,0,0,0,0,0,0,0,0,0,0,0,0,0,0,0,0,0,0,0,0,0,0,0,0,0,0,0,0,0,0,0,0,0,0,0,0,0,0
0,0,0,0,0,0,0,0,0,0,0,0,0,0,0,0,0,0,0,0,0,0,0,0,0,9006,9006,9006,9006,9006,9006,9006,9006,9006,9006,0,0,0,0,0,0,0,0,0,0,0,0,0,0,0,0,0,0,0,0,0,0,0,0,0,0,0,0,0
0,0,0,0,0,0,0,0,0,0,0,0,0,0,0,9008,9008,9008,9008,9008,9008,9008,9008,9008,0,9006,9006,9006,9006,9006,9006,9006,9006,9006,9006,0,9007,9007,9007,9007,9007,9007,0,0,0,0,0,0,0,0,0,0,0,0,0,0,0,0,0,0,0,0,0,0
0,0,0,0,0,0,0,0,0,0,0,0,0,0,0,9008,9008,9008,9008,9008,9008,9008,9008,9008,0,9006,9006,9006,9006,9006,9006,9006,9006,9006,9006,0,9007,9007,9007,9007,9007,9007,0,0,0,0,0,0,0,0,0,0,0,0,0,0,0,0,0,0,0,0,0,0
0,0,0,0,0,0,0,0,0,0,0,0,0,0,0,9008,9008,9008,9008,9008,9008,9008,9008,9008,0,9006,9006,9006,9006,9006,9006,9006,9006,9006,9006,0,9007,9007,9007,9007,9007,9007,0,0,0,0,0,0,0,0,0,0,0,0,0,0,0,0,0,0,0,0,0,0
0,0,0,0,0,0,0,0,0,0,0,0,0,0,0,9008,9008,9008,9008,0,0,0,0,0,0,9006,9006,9006,9006,9006,9006,9006,9006,9006,9006,0,9007,9007,9007,9007,9007,9007,0,0,0,0,0,0,0,0,0,0,0,0,0,0,0,0,0,0,0,0,0,0
0,0,0,0,0,0,0,0,0,0,0,0,0,0,0,9008,9008,9008,9008,0,0,0,0,0,0,0,0,0,9006,9006,9006,9006,0,0,0,0,0,0,0,0,0,0,0,0,0,0,0,0,0,0,0,0,0,0,0,0,0,0,0,0,0,0,0,0
0,0,0,0,0,0,0,0,0,0,0,0,0,0,0,9008,9008,9008,9008,0,0,0,0,0,0,0,0,0,0,0,0,0,0,0,0,0,0,0,0,0,0,0,0,0,0,0,0,0,0,0,0,0,0,0,0,0,0,0,0,0,0,0,0,0
0,0,0,0,0,0,0,0,0,0,0,0,0,0,0,9008,9008,9008,9008,0,0,0,0,0,0,0,0,0,0,9005,9005,9005,0,0,0,0,0,0,0,0,0,0,0,0,0,0,0,0,0,0,0,0,0,0,0,0,0,0,0,0,0,0,0,0
0,0,0,0,0,0,0,0,0,0,0,0,0,0,0,9008,9008,9008,9008,0,0,0,0,0,0,0,0,0,0,9005,9005,9005,0,0,0,0,0,0,0,0,0,0,0,0,0,0,0,0,0,0,0,0,0,0,0,0,0,0,0,0,0,0,0,0
0,0,0,0,0,0,0,0,0,0,0,0,0,0,0,9008,9008,9008,9008,0,0,0,0,0,0,0,0,0,0,9005,9005,9005,0,0,0,0,0,0,0,0,0,0,0,0,0,0,0,0,0,0,0,0,0,0,0,0,0,0,0,0,0,0,0,0
0,0,9013,9013,9013,9013,0,9009,9009,9009,9009,9009,0,9008,9008,9008,9008,9008,9008,9008,9008,9008,0,0,0,0,0,0,0,9005,9005,9005,0,0,0,0,0,0,0,0,0,0,0,0,0,0,0,0,0,0,0,0,0,0,0,0,0,0,0,0,0,0,0,0
0,0,9013,9013,9013,9013,0,9009,9009,9009,9009,9009,0,9008,9008,9008,9008,9008,9008,9008,9008,9008,0,0,0,0,0,9005,9005,9005,9005,9005,9005,9005,0,0,0,0,0,0,0,0,0,0,0,0,0,0,0,0,0,0,0,0,0,0,0,0,0,0,0,0,0,0
0,0,9013,9013,9013,9013,0,9009,9009,9009,9009,9009,0,9008,9008,9008,9008,9008,9008,9008,9008,9008,0,0,0,0,0,0,0,9005,9005,9005,0,0,0,0,0,0,0,0,0,0,0,0,0,0,0,0,0,0,0,0,0,0,0,0,0,0,0,0,0,0,0,0
0,0,9013,9013,9013,9013,0,9009,9009,9009,9009,9009,0,0,0,0,0,0,0,0,0,0,0,0,0,0,0,0,0,9005,9005,9005,0,0,0,0,0,0,0,0,0,0,0,0,0,0,0,0,0,0,0,0,0,0,0,0,0,0,0,0,0,0,0,0
0,0,0,0,0,0,0,0,0,0,0,0,0,0,0,0,0,0,0,0,0,0,0,0,0,0,0,0,0,9005,9005,9005,0,0,0,0,0,0,0,0,0,0,0,0,0,0,0,0,0,0,0,0,0,0,0,0,0,0,0,0,0,0,0,0
0,0,9014,9014,9014,9014,0,9010,9010,9010,0,0,0,0,0,0,0,0,0,0,0,0,0,0,0,0,0,0,0,9005,9005,9005,0,0,0,0,0,0,0,0,0,0,0,0,0,0,0,0,0,0,0,0,0,0,0,0,0,0,0,0,0,0,0,0
0,0,9014,9014,9014,9014,0,9010,9010,9010,0,0,0,0,0,0,0,0,0,0,0,0,0,0,0,0,0,0,0,0,0,0,0,0,0,0,0,0,0,0,0,0,0,0,0,0,0,0,0,0,0,0,0,0,0,0,0,0,0,0,0,0,0,0
0,0,9014,9014,9014,9014,0,9010,9010,9010,0,0,0,0,0,0,0,0,0,0,0,0,0,0,9003,9003,9003,9003,9003,9003,9003,9003,9003,9003,9003,9003,9003,9003,0,0,0,0,0,0,0,9016,9016,9016,9016,9016,9016,9016,9016,0,0,0,0,0,0,0,0,0,0,0
0,0,9014,9014,9014,9014,0,9010,9010,9010,0,0,0,0,0,0,0,0,0,0,0,0,0,0,9003,9003,9003,9003,9003,9003,9003,9003,9003,9003,9003,9003,9003,9003,0,0,0,0,0,0,0,9016,9016,9016,9016,9016,9016,9016,9016,0,0,0,0,0,0,0,0,0,0,0
0,0,9014,9014,9014,9014,0,0,0,0,0,0,0,0,0,0,0,0,0,0,0,0,0,0,9003,9003,9003,9003,9003,9003,9003,9003,9003,9003,9003,9003,9003,9003,0,9004,9004,9004,9004,9004,0,9016,9016,9016,9016,9016,9016,9016,9016,0,0,0,0,0,0,0,0,0,0,0
0,0,9014,9014,9014,9014,0,9011,9011,9011,9011,9011,9011,9011,9011,9011,9011,9011,0,0,0,0,0,0,9003,9003,9003,9003,9003,9003,9003,9003,9003,9003,9003,9003,9003,9003,0,9004,9004,9004,9004,9004,0,9016,9016,9016,9016,9016,9016,9016,9016,0,0,0,0,0,0,0,0,0,0,0
0,0,9014,9014,9014,9014,0,9011,9011,9011,9011,9011,9011,9011,9011,9011,9011,9011,0,0,0,0,0,0,9003,9003,9003,9003,9003,9003,9003,9003,9003,9003,9003,9003,9003,9003,0,9004,9004,9004,9004,9004,0,9016,9016,9016,9016,9016,9016,9016,9016,0,0,0,0,0,0,0,0,0,0,0
0,0,9014,9014,9014,9014,0,9011,9011,9011,9011,9011,9011,9011,9011,9011,9011,9011,0,0,0,0,0,0,9003,9003,9003,9003,9003,9003,9003,9003,9003,9003,9003,9003,9003,9003,0,0,0,9004,9004,9004,0,9016,9016,9016,9016,9016,9016,9016,9016,0,0,0,0,0,0,0,0,0,0,0
0,0,9014,9014,9014,9014,0,9011,9011,9011,9011,9011,9011,9011,9011,9011,9011,9011,0,0,0,0,0,0,9003,9003,9003,9003,9003,9003,9003,9003,9003,9003,9003,9003,9003,9003,0,0,0,9004,9004,9004,0,9016,9016,9016,9016,9016,9016,9016,9016,0,0,0,0,0,0,0,0,0,0,0
0,0,9014,9014,9014,9014,0,9011,9011,9011,9011,9011,9011,9011,9011,9011,9011,9011,0,0,0,0,0,0,0,0,0,0,0,0,0,0,0,0,0,0,0,0,0,0,0,9004,9004,9004,0,9016,9016,9016,9016,9016,9016,9016,9016,0,0,0,0,0,0,0,0,0,0,0
0,0,9014,9014,9014,9014,0,0,0,0,0,0,0,0,0,0,0,0,0,0,0,0,0,0,0,0,0,0,0,9002,9002,9002,0,0,0,0,0,0,0,0,0,9004,9004,9004,0,0,0,0,0,0,0,0,0,0,0,0,0,0,0,0,0,0,0,0
0,0,9014,9014,9014,9014,0,9012,9012,9012,0,0,0,0,0,0,0,0,0,0,0,0,0,0,0,0,0,0,0,9002,9002,9002,0,0,0,0,0,0,0,0,0,9004,9004,9004,0,9017,9017,9017,9017,9017,9017,9017,9017,0,0,0,0,0,0,0,0,0,0,0
0,0,9014,9014,9014,9014,0,9012,9012,9012,0,0,0,0,0,0,0,0,0,0,0,0,0,0,0,0,0,0,0,9002,9002,9002,0,0,0,0,0,0,0,0,0,9004,9004,9004,0,9017,9017,9017,9017,9017,9017,9017,9017,0,0,0,0,0,0,0,0,0,0,0
0,0,9014,9014,9014,9014,0,9012,9012,9012,0,0,0,0,0,0,0,0,0,0,0,0,0,0,0,0,0,0,0,9002,9002,9002,0,0,0,0,0,0,0,0,0,9004,9004,9004,0,9017,9017,9017,9017,9017,9017,9017,9017,0,0,0,0,0,0,0,0,0,0,0
0,0,9014,9014,9014,9014,0,9012,9012,9012,0,0,0,0,0,0,0,0,0,0,0,0,0,0,0,0,0,0,0,9002,9002,9002,0,0,0,0,0,0,0,0,0,9004,9004,9004,0,9017,9017,9017,9017,9017,9017,9017,9017,0,0,0,0,0,0,0,0,0,0,0
0,0,9014,9014,9014,9014,0,0,0,0,0,0,0,0,0,0,0,0,0,0,0,0,0,0,0,0,0,0,0,9002,9002,9002,0,0,0,0,0,0,0,0,0,9004,9004,9004,0,9017,9017,9017,9017,9017,9017,9017,9017,0,0,0,0,0,0,0,0,0,0,0
0,0,9014,9014,9014,9014,9014,9014,9014,9014,9014,9014,9014,9014,9014,0,0,0,0,0,0,0,0,0,0,0,0,0,0,9002,9002,9002,0,0,0,0,0,0,0,0,0,0,0,0,0,0,0,0,0,0,0,0,0,0,0,0,0,0,0,0,0,0,0,0
0,0,9014,9014,9014,9014,9014,9014,9014,9014,9014,9014,9014,9014,9014,0,9015,9015,0,0,0,0,0,0,0,0,0,0,0,9002,9002,9002,0,0,0,0,0,0,0,0,0,0,0,0,0,0,0,0,0,0,0,0,0,0,0,0,0,0,0,0,0,0,0,0
0,0,9014,9014,9014,9014,9014,9014,9014,9014,9014,9014,9014,9014,9014,0,9015,9015,0,0,0,0,0,0,0,0,0,0,0,9002,9002,9002,0,0,0,0,0,0,0,0,0,0,0,0,0,0,0,0,0,0,0,0,0,0,0,0,0,0,0,0,0,0,0,0
0,0,9014,9014,9014,9014,9014,9014,9014,9014,9014,9014,9014,9014,9014,0,9015,9015,0,0,0,0,0,0,0,0,0,0,0,9002,9002,9002,0,0,0,0,0,0,0,0,0,0,0,0,0,0,0,0,0,0,0,0,0,0,0,0,0,0,0,0,0,0,0,0
0,0,0,0,0,0,0,0,0,0,0,0,0,0,0,0,0,0,0,0,0,0,0,0,0,0,0,0,0,0,0,0,0,0,0,0,0,0,0,0,0,0,0,0,0,0,0,0,0,0,0,0,0,0,0,0,0,0,0,0,0,0,0,0
0,0,0,0,0,0,0,0,0,0,0,0,0,0,0,0,0,0,0,0,0,0,0,0,0,0,0,0,0,9001,9001,9001,0,0,0,0,0,0,0,0,0,0,0,0,0,0,0,0,0,0,0,0,0,0,0,0,0,0,0,0,0,0,0,0
0,0,0,0,0,0,0,0,0,0,0,0,0,0,0,0,0,0,0,0,0,0,0,9001,9001,9001,9001,9001,0,9001,9001,9001,0,9001,9001,9001,9001,0,0,0,0,0,0,0,0,0,0,0,0,0,0,0,0,0,0,0,0,0,0,0,0,0,0,0
0,0,0,0,0,0,0,0,0,0,0,0,0,0,0,0,0,0,0,0,0,0,0,9001,9001,9001,9001,9001,0,9001,9001,9001,0,9001,9001,9001,9001,0,0,0,0,0,0,0,0,0,0,0,0,0,0,0,0,0,0,0,0,0,0,0,0,0,0,0
0,0,0,0,0,0,0,0,0,0,0,0,0,0,0,0,0,0,0,0,0,0,0,9001,9001,9001,9001,9001,0,9001,9001,9001,0,9001,9001,9001,9001,0,0,0,0,0,0,0,0,0,0,0,0,0,0,0,0,0,0,0,0,0,0,0,0,0,0,0
0,0,0,0,0,0,0,0,0,0,0,0,0,0,0,0,0,0,0,0,0,0,0,0,0,0,0,0,0,9001,9001,9001,0,0,0,0,0,0,0,0,0,0,0,0,0,0,0,0,0,0,0,0,0,0,0,0,0,0,0,0,0,0,0,0
0,0,0,0,0,0,0,0,0,0,0,0,0,0,0,0,0,0,0,0,0,0,0,9001,9001,9001,9001,9001,0,9001,9001,9001,0,9001,9001,9001,9001,0,0,0,0,0,0,0,0,0,0,0,0,0,0,0,0,0,0,0,0,0,0,0,0,0,0,0
0,0,0,0,0,0,0,0,0,0,0,0,0,0,0,0,0,0,0,0,0,0,0,9001,9001,9001,9001,9001,0,9001,9001,9001,0,9001,9001,9001,9001,0,0,0,0,0,0,0,0,0,0,0,0,0,0,0,0,0,0,0,0,0,0,0,0,0,0,0
0,0,0,0,0,0,0,0,0,0,0,0,0,0,0,0,0,0,0,0,0,0,0,9001,9001,9001,9001,9001,0,9001,9001,9001,0,9001,9001,9001,9001,0,0,0,0,0,0,0,0,0,0,0,0,0,0,0,0,0,0,0,0,0,0,0,0,0,0,0
0,0,0,0,0,0,0,0,0,0,0,0,0,0,0,0,0,0,0,0,0,0,0,0,0,0,0,0,0,9001,9001,9001,0,0,0,0,0,0,0,0,0,0,0,0,0,0,0,0,0,0,0,0,0,0,0,0,0,0,0,0,0,0,0,0
0,0,0,0,0,0,0,0,0,0,0,0,0,0,0,0,0,0,0,0,0,0,0,9001,9001,9001,9001,9001,9001,9001,9001,9001,9001,9001,9001,9001,9001,0,0,0,0,0,0,0,0,0,0,0,0,0,0,0,0,0,0,0,0,0,0,0,0,0,0,0
0,0,0,0,0,0,0,0,0,0,0,0,0,0,0,0,0,0,0,0,0,0,0,9001,9001,9001,9001,9001,9001,9001,9001,9001,9001,9001,9001,9001,9001,0,0,0,0,0,0,0,0,0,0,0,0,0,0,0,0,0,0,0,0,0,0,0,0,0,0,0
0,0,0,0,0,0,0,0,0,0,0,0,0,0,0,0,0,0,0,0,0,0,0,9001,9001,9001,9001,9001,9001,9001,9001,9001,9001,9001,9001,9001,9001,0,0,0,0,0,0,0,0,0,0,0,0,0,0,0,0,0,0,0,0,0,0,0,0,0,0,0
0,0,0,0,0,0,0,0,0,0,0,0,0,0,0,0,0,0,0,0,0,0,0,9001,9001,9001,9001,9001,9001,9001,9001,9001,9001,9001,9001,9001,9001,0,0,0,0,0,0,0,0,0,0,0,0,0,0,0,0,0,0,0,0,0,0,0,0,0,0,0
0,0,0,0,0,0,0,0,0,0,0,0,0,0,0,0,0,0,0,0,0,0,0,0,0,0,0,0,0,0,0,0,0,0,0,0,0,0,0,0,0,0,0,0,0,0,0,0,0,0,0,0,0,0,0,0,0,0,0,0,0,0,0,0
0,0,0,0,0,0,0,0,0,0,0,0,0,0,0,0,0,0,0,0,0,0,0,0,0,0,0,0,0,0,0,0,0,0,0,0,0,0,0,0,0,0,0,0,0,0,0,0,0,0,0,0,0,0,0,0,0,0,0,0,0,0,0,0
0,0,0,0,0,0,0,0,0,0,0,0,0,0,0,0,0,0,0,0,0,0,0,0,0,0,0,0,0,0,0,0,0,0,0,0,0,0,0,0,0,0,0,0,0,0,0,0,0,0,0,0,0,0,0,0,0,0,0,0,0,0,0,0
0,0,0,0,0,0,0,0,0,0,0,0,0,0,0,0,0,0,0,0,0,0,0,0,0,0,0,0,0,0,0,0,0,0,0,0,0,0,0,0,0,0,0,0,0,0,0,0,0,0,0,0,0,0,0,0,0,0,0,0,0,0,0,0
0,0,0,0,0,0,0,0,0,0,0,0,0,0,0,0,0,0,0,0,0,0,0,0,0,0,0,0,0,0,0,0,0,0,0,0,0,0,0,0,0,0,0,0,0,0,0,0,0,0,0,0,0,0,0,0,0,0,0,0,0,0,0,0
