64
1040
1044
0,0,0,0,0,0,0,0,0,0,0,0,0,0,0,0,0,0,0,0,0,0,0,0,0,0,0,0,0,0,0,0,0,0,0,0,0,0,0,0,0,0,0,0,0,0,0,0,0,0,0,0,0,0,0,0,0,0,0,0,0,0,0,0
0,0,0,0,0,0,0,0,0,0,0,0,0,0,0,0,0,0,0,0,0,0,0,0,0,0,0,0,0,0,0,0,0,0,0,0,0,0,0,0,0,0,0,0,0,0,0,0,0,0,0,0,0,0,0,0,0,0,0,0,0,0,0,0
0,0,0,0,0,0,0,0,0,0,0,0,0,0,0,0,0,0,0,0,0,0,0,0,1029,1029,1029,1029,1029,1029,1029,1029,1029,0,0,0,0,0,0,0,0,0,0,0,0,0,0,0,0,0,0,0,0,0,0,0,0,0,0,0,0,0,0,0
0,0,0,0,0,0,0,0,0,0,0,0,0,0,0,0,0,0,0,0,0,0,0,0,1029,5001,5001,5001,5001,5001,5001,5001,1029,0,0,0,0,0,0,0,0,0,0,0,0,1030,1030,1030,1030,1030,1030,1030,0,0,0,0,0,0,0,0,0,0,0,0
0,0,0,0,0,0,0,0,0,0,0,0,0,0,0,0,0,0,0,0,0,0,0,0,1029,0,0,0,0,0,0,0,1029,1030,1030,1030,1030,1030,1030,1030,1030,1030,1030,1030,1030,1030,0,0,0,0,0,1030,0,0,0,0,0,0,0,0,0,0,0,0
0,0,0,0,0,0,0,0,0,0,0,0,0,0,0,0,0,0,0,0,0,0,0,0,1029,0,5007,0,0,0,0,0,1029,0,0,0,0,0,0,0,0,0,0,0,2028,1030,0,1012,1012,1012,0,1030,0,0,0,0,0,0,0,0,0,0,0,0
0,0,0,0,0,0,0,0,0,0,0,0,0,0,0,0,0,0,0,0,0,0,0,0,1029,0,0,0,2049,0,5007,0,3001,0,0,0,0,0,0,0,0,0,0,0,0,3003,0,3001,4011,1012,0,1030,0,0,0,0,0,0,0,0,0,0,0,0
0,0,0,0,0,0,0,0,0,0,0,0,0,0,0,0,0,0,0,0,0,0,0,0,1029,5007,0,0,0,5007,0,0,1029,0,0,0,0,0,0,0,0,0,0,0,2028,1030,0,1012,1012,1012,0,1030,0,0,0,0,0,0,0,0,0,0,0,0
0,0,0,0,0,0,0,0,0,0,0,0,0,0,0,0,0,0,0,0,0,0,0,0,1029,0,0,0,0,0,0,0,1029,1030,1030,1030,1030,1030,1030,1030,1030,1030,1030,1030,1030,1030,0,0,0,0,0,1030,0,0,0,0,0,0,0,0,0,0,0,0
0,0,0,0,0,0,0,0,0,0,0,0,0,0,0,0,0,0,0,0,0,0,0,0,1029,0,0,5007,0,0,0,0,1029,0,0,0,0,0,0,0,0,0,0,0,0,1030,1030,1030,1030,1030,1030,1030,0,0,0,0,0,0,0,0,0,0,0,0
0,0,0,0,0,0,0,0,0,0,0,0,0,0,0,0,0,0,0,0,0,0,0,0,1029,0,0,0,0,0,5007,0,1029,0,0,0,0,0,0,0,0,0,0,0,0,0,0,0,0,0,0,0,0,0,0,0,0,0,0,0,0,0,0,0
0,0,0,0,0,0,0,0,0,0,0,0,0,0,0,0,0,0,0,0,0,0,0,0,1029,0,5007,0,0,0,0,0,1029,0,0,0,0,0,0,0,0,0,0,0,0,0,0,0,0,0,0,0,0,0,0,0,0,0,0,0,0,0,0,0
0,0,0,0,0,0,0,0,0,0,0,1029,1029,1029,1029,1029,1029,1029,1029,1029,1029,1029,1029,1029,1029,1029,1029,1029,3002,1029,1029,1029,1029,1029,1029,1029,1029,1029,1029,1029,1029,1029,1029,1029,1029,0,0,0,0,0,0,0,0,0,0,0,0,0,0,0,0,0,0,0
0,0,0,0,0,0,0,0,0,0,0,1029,0,0,0,5002,0,0,5002,0,5003,5002,0,5003,5002,0,2026,5007,5007,5007,2026,0,5002,5003,0,5002,5003,0,5002,0,0,5002,0,0,1029,0,0,0,0,0,0,0,0,0,0,0,0,0,0,0,0,0,0,0
0,0,0,0,0,0,0,0,0,0,0,1029,0,0,0,0,0,0,0,0,0,0,0,0,0,0,0,0,0,0,0,0,0,0,0,0,0,0,0,0,0,0,0,0,1029,0,0,0,0,0,0,0,0,0,0,0,0,0,0,0,0,0,0,0
0,0,0,0,0,0,0,0,0,0,0,1029,0,0,0,0,0,0,0,0,0,0,0,0,0,0,0,0,0,5007,0,0,0,0,0,0,0,0,0,0,0,0,0,0,1029,0,0,0,0,0,0,0,0,0,0,0,0,0,0,0,0,0,0,0
0,0,0,0,0,0,0,0,0,0,0,1029,0,0,0,0,0,0,0,0,0,0,0,0,0,5007,0,0,0,0,0,5007,0,0,0,0,0,0,0,0,0,0,0,0,1029,0,0,0,0,0,0,0,0,0,0,0,0,0,0,0,0,0,0,0
0,0,0,0,0,0,0,0,0,0,0,1029,0,0,0,0,1029,1029,1029,1029,1029,1029,1029,1029,0,0,0,0,5007,0,0,0,0,1029,1029,1029,1029,1029,1029,1029,1029,0,0,0,1029,0,0,0,0,0,0,0,0,0,0,0,0,0,0,0,0,0,0,0
0,0,0,0,0,0,0,0,0,0,0,1029,0,0,0,0,1029,0,0,0,0,0,0,1029,0,0,5004,0,0,0,5004,0,0,1029,0,0,0,0,0,0,1029,0,0,0,1029,0,0,0,0,0,0,0,0,0,0,0,0,0,0,0,0,0,0,0
0,0,0,0,0,0,0,0,0,0,0,1029,0,5004,0,0,1029,0,0,0,0,0,0,1029,0,0,0,0,0,0,0,5007,0,1029,0,0,0,0,0,0,1029,0,5004,0,1029,0,0,0,0,0,0,0,0,0,0,0,0,0,0,0,0,0,0,0
0,1030,1030,1030,1030,1030,1030,1030,1030,1030,1030,1029,0,0,0,0,1029,0,0,0,0,0,0,1029,0,0,0,5007,0,0,0,0,0,1029,0,0,0,0,0,0,1029,0,0,0,1029,1030,1030,1030,1030,1030,1030,1030,1030,1030,1030,0,0,0,0,0,0,0,0,0
0,1030,0,0,0,0,0,0,0,0,1030,1029,0,0,0,0,1029,0,0,0,0,0,0,1029,0,0,0,0,0,0,0,0,0,1029,0,0,0,0,0,0,1029,0,0,0,1029,1030,0,0,0,0,0,0,0,0,1030,0,0,0,0,0,0,0,0,0
0,1030,0,5001,0,0,0,0,0,0,1030,1029,0,0,0,0,1029,0,0,0,0,0,0,1029,0,5007,0,0,0,0,0,0,0,1029,0,0,0,0,0,0,1029,0,0,0,1029,1030,0,0,5001,0,0,0,0,0,1030,0,0,0,0,0,0,0,0,0
0,1030,0,0,0,0,0,5001,0,0,0,1029,0,0,0,0,1029,0,0,0,0,0,0,1029,0,0,0,0,0,0,0,0,0,1029,0,0,0,0,0,0,1029,0,0,0,1029,0,0,0,0,0,0,5001,0,0,1030,0,0,0,0,0,0,0,0,0
0,1030,0,0,0,0,0,0,0,0,0,1029,0,0,0,0,1029,1029,1029,1029,1029,1029,1029,1029,0,0,5004,0,0,0,5004,0,0,1029,1029,1029,1029,1029,1029,1029,1029,0,0,0,1029,0,0,0,0,0,0,0,0,0,1030,0,0,0,0,0,0,0,0,0
0,1030,0,0,5001,0,0,5001,0,0,0,3005,0,0,0,0,0,0,0,0,0,0,0,0,0,0,0,0,0,0,0,0,0,0,0,0,0,0,0,0,0,0,0,0,3005,0,0,0,0,5001,0,0,0,0,1030,0,0,0,0,0,0,0,0,0
0,1030,0,0,0,0,0,0,0,0,0,1029,0,0,0,0,0,0,0,0,0,0,0,0,0,0,0,0,0,0,0,0,0,0,0,0,0,0,0,0,0,0,0,0,1029,0,0,0,5001,0,0,0,0,0,1030,0,0,0,0,0,0,0,0,0
0,1030,0,5001,0,0,0,0,0,0,0,1029,0,0,0,0,1029,1029,1029,1029,1029,1029,1029,1029,0,0,0,0,0,0,0,0,0,1029,1029,1029,1029,1029,1029,1029,1029,0,0,0,1029,0,0,0,0,0,0,0,5001,0,1030,0,0,0,0,0,0,0,0,0
0,1030,0,0,0,0,0,5001,0,0,1030,1029,0,0,0,0,1029,0,0,0,0,0,0,1029,0,0,0,0,0,0,0,5007,0,1029,0,0,0,0,0,0,1029,0,0,0,1029,1030,0,0,0,0,0,0,0,0,1030,0,0,0,0,0,0,0,0,0
0,1030,0,0,0,0,0,0,0,0,1030,1029,0,0,0,0,1029,0,0,0,0,0,0,1029,0,0,0,0,0,0,0,0,0,1029,0,0,0,0,0,0,1029,0,0,0,1029,1030,0,4003,4003,4003,4003,4003,4003,0,1030,0,0,0,0,0,0,0,0,0
0,1030,0,4007,4007,4007,4007,4007,4007,0,1030,1029,0,5004,0,0,1029,0,0,0,0,0,0,1029,0,0,5004,0,0,0,5004,0,0,1029,0,0,0,0,0,0,1029,0,0,0,1029,1030,0,4003,4003,4003,4003,4003,4003,0,1030,0,0,0,0,0,0,0,0,0
0,1030,0,4007,4007,4007,4007,4007,4007,0,1030,1029,0,0,0,0,1029,0,0,0,0,0,0,1029,0,0,0,0,0,0,0,0,0,1029,0,0,0,0,0,0,1029,0,5004,0,1029,1030,0,4003,4003,4003,4003,4003,4003,0,1030,0,0,0,0,0,0,0,0,0
0,1030,0,4007,4007,4007,4007,4007,4007,0,1030,1029,0,0,0,0,1029,0,0,0,0,0,0,1029,0,0,0,0,0,0,0,0,0,1029,0,0,0,0,0,0,1029,0,0,0,1029,1030,0,4003,4003,4003,4003,4003,4003,0,1030,0,0,0,0,0,0,0,0,0
0,1030,0,4007,4007,4007,4007,4007,4007,0,1030,1029,0,0,0,0,1029,0,0,0,0,0,0,1029,0,5007,0,0,0,0,0,0,0,1029,0,0,0,0,0,0,1029,0,0,0,1029,1030,0,4003,4003,4003,4003,4003,4003,0,1030,0,0,0,0,0,0,0,0,0
0,1030,0,4007,4007,4007,4007,4007,4007,0,1030,1029,0,0,0,0,1029,1029,1029,1029,1029,1029,1029,1029,0,0,0,0,0,0,0,0,0,1029,1029,1029,1029,1029,1029,1029,1029,0,0,0,1029,1030,0,4003,4003,4003,4003,4003,4003,0,1030,0,0,0,0,0,0,0,0,0
0,1030,0,4007,4007,4007,4007,4007,4007,0,1030,1029,0,0,0,0,0,0,0,0,0,0,0,0,0,0,0,0,0,0,0,0,0,0,0,0,0,0,0,0,0,0,0,0,1029,1030,0,4003,4003,4003,4003,4003,4003,0,1030,0,0,0,0,0,0,0,0,0
0,1030,0,4007,4007,4007,4007,4007,4007,0,1030,1029,0,0,0,0,0,0,0,0,0,0,0,0,0,0,5004,0,0,0,5004,0,0,0,0,0,0,0,0,0,0,0,0,0,1029,1030,0,4003,4003,4003,4003,4003,4003,0,1030,0,0,0,0,0,0,0,0,0
0,1030,0,4007,4007,4007,4007,4007,4007,0,1030,1029,0,0,0,0,1029,1029,1029,1029,1029,1029,1029,1029,0,0,0,0,0,0,0,0,0,1029,1029,1029,1029,1029,1029,1029,1029,0,0,0,1029,1030,0,4003,4003,4003,4003,4003,4003,0,1030,0,0,0,0,0,0,0,0,0
0,1030,0,4007,4007,4007,4007,4007,4007,0,1030,1029,0,0,0,0,1029,1029,1029,0,0,0,0,1029,0,0,0,0,0,0,0,0,0,1029,0,0,0,0,0,0,1029,0,0,0,1029,1030,0,0,0,0,0,0,0,0,1030,0,0,0,0,0,0,0,0,0
0,1030,0,0,0,0,0,0,0,0,1030,1029,0,0,0,0,1029,1029,1029,0,0,4009,0,1029,0,0,0,0,0,0,0,0,0,1029,0,0,0,0,0,0,1029,0,0,0,1029,1030,0,0,0,0,0,0,0,0,1030,0,0,0,0,0,0,0,0,0
0,1030,0,0,0,0,0,0,0,0,1030,1029,0,5004,0,0,1029,1029,1029,0,0,0,0,1029,0,0,0,0,0,0,0,0,0,1029,0,0,0,0,0,0,1029,0,0,0,1029,1030,1030,1030,1030,1030,1030,1030,1030,1030,1030,0,0,0,0,0,0,0,0,0
0,1030,1030,1030,1030,1030,1030,1030,1030,1030,1030,1029,0,0,0,0,3001,0,0,0,0,0,0,1029,0,0,5004,0,0,0,5004,0,0,1029,0,0,0,0,0,0,1029,0,5004,0,1029,0,0,0,0,0,0,0,0,0,0,0,0,0,0,0,0,0,0,0
0,0,0,0,0,0,0,0,0,0,0,1029,0,0,0,0,1029,1029,1029,1029,1029,1029,1029,1029,0,0,0,0,5007,0,0,0,0,1029,0,0,0,0,0,0,1029,0,0,0,1029,0,0,0,0,0,0,0,0,0,0,0,0,0,0,0,0,0,0,0
0,0,0,0,0,0,0,0,0,0,0,1029,0,0,0,0,1029,1029,1029,1029,1029,1029,1029,1029,0,0,0,0,0,0,0,0,0,1029,1029,1029,1029,1029,1029,1029,1029,0,0,0,1029,0,0,0,0,0,0,0,0,0,0,0,0,0,0,0,0,0,0,0
0,0,0,0,0,0,0,0,0,0,0,1029,0,0,0,0,0,0,0,0,0,0,0,0,0,0,0,0,0,0,0,0,0,0,0,0,0,0,0,0,0,0,0,0,1029,0,0,0,0,0,0,0,0,0,0,0,0,0,0,0,0,0,0,0
0,0,0,0,0,0,0,0,0,0,0,1029,1029,1029,1029,1029,1029,1029,1029,1029,1029,1029,1029,1029,1029,1029,1029,1029,3002,1029,1029,1029,1029,1029,1029,1029,1029,1029,1029,1029,1029,1029,1029,1029,1029,0,0,0,0,0,0,0,0,0,0,0,0,0,0,0,0,0,0,0
0,0,0,0,0,0,0,0,0,0,0,0,0,0,0,0,0,0,0,0,0,0,0,0,1029,5003,5003,0,5001,0,5003,5003,1029,0,0,0,0,0,0,0,0,0,0,0,0,0,0,0,0,0,0,0,0,0,0,0,0,0,0,0,0,0,0,0
0,0,0,0,0,0,0,0,0,0,0,0,0,0,0,0,0,0,0,0,0,0,0,0,1029,5003,0,5007,0,0,0,5003,1029,0,0,0,0,0,0,0,0,0,0,0,0,0,0,0,0,0,0,0,0,0,0,0,0,0,0,0,0,0,0,0
0,0,0,0,0,0,0,0,0,0,0,0,0,0,0,0,0,0,0,0,0,0,0,0,1029,5003,0,0,0,0,0,5003,1029,0,0,0,0,0,0,0,0,0,0,0,0,0,0,0,0,0,0,0,0,0,0,0,0,0,0,0,0,0,0,0
0,0,0,0,0,0,0,0,0,0,0,0,0,0,0,0,0,0,0,0,0,0,0,0,1029,5003,0,0,0,5007,0,5003,1029,0,0,0,0,0,0,0,0,0,0,0,0,0,0,0,0,0,0,0,0,0,0,0,0,0,0,0,0,0,0,0
0,0,0,0,0,0,0,0,0,0,0,0,0,0,0,0,0,0,0,0,0,0,0,0,1029,5003,0,0,0,0,0,5003,1029,0,0,0,0,0,0,0,0,0,0,0,0,0,0,0,0,0,0,0,0,0,0,0,0,0,0,0,0,0,0,0
0,0,0,0,0,0,0,0,0,0,0,0,0,0,0,0,0,0,0,0,0,0,0,0,1029,5003,0,0,0,0,0,5003,1029,0,0,0,0,0,0,0,0,0,0,0,0,0,0,0,0,0,0,0,0,0,0,0,0,0,0,0,0,0,0,0
0,0,0,0,0,0,0,0,0,0,0,0,0,0,0,0,0,0,0,0,0,0,0,0,1029,0,0,0,0,0,0,0,1029,0,0,0,0,0,0,0,0,0,0,0,0,0,0,0,0,0,0,0,0,0,0,0,0,0,0,0,0,0,0,0
0,0,0,0,0,0,0,0,0,0,0,0,0,0,0,0,0,0,0,0,0,0,0,0,1029,0,0,0,4010,0,0,0,1029,0,0,0,0,0,0,0,0,0,0,0,0,0,0,0,0,0,0,0,0,0,0,0,0,0,0,0,0,0,0,0
0,0,0,0,0,0,0,0,0,0,0,0,0,0,0,0,0,0,0,0,0,0,0,0,1029,0,0,0,0,0,0,0,1029,0,0,0,0,0,0,0,0,0,0,0,0,0,0,0,0,0,0,0,0,0,0,0,0,0,0,0,0,0,0,0
0,0,0,0,0,0,0,0,0,0,0,0,0,0,0,0,0,0,0,0,0,0,0,0,1029,1029,1029,1029,1029,1029,1029,1029,1029,0,0,0,0,0,0,0,0,0,0,0,0,0,0,0,0,0,0,0,0,0,0,0,0,0,0,0,0,0,0,0
0,0,0,0,0,0,0,0,0,0,0,0,0,0,0,0,0,0,0,0,0,0,0,0,0,0,0,0,0,0,0,0,0,0,0,0,0,0,0,0,0,0,0,0,0,0,0,0,0,0,0,0,0,0,0,0,0,0,0,0,0,0,0,0
0,0,0,0,0,0,0,0,0,0,0,0,0,0,0,0,0,0,0,0,0,0,0,0,0,0,0,0,0,0,0,0,0,0,0,0,0,0,0,0,0,0,0,0,0,0,0,0,0,0,0,0,0,0,0,0,0,0,0,0,0,0,0,0
0,0,0,0,0,0,0,0,0,0,0,0,0,0,0,0,0,0,0,0,0,0,0,0,0,0,0,0,0,0,0,0,0,0,0,0,0,0,0,0,0,0,0,0,0,0,0,0,0,0,0,0,0,0,0,0,0,0,0,0,0,0,0,0
0,0,0,0,0,0,0,0,0,0,0,0,0,0,0,0,0,0,0,0,0,0,0,0,0,0,0,0,0,0,0,0,0,0,0,0,0,0,0,0,0,0,0,0,0,0,0,0,0,0,0,0,0,0,0,0,0,0,0,0,0,0,0,0
0,0,0,0,0,0,0,0,0,0,0,0,0,0,0,0,0,0,0,0,0,0,0,0,0,0,0,0,0,0,0,0,0,0,0,0,0,0,0,0,0,0,0,0,0,0,0,0,0,0,0,0,0,0,0,0,0,0,0,0,0,0,0,0
0,0,0,0,0,0,0,0,0,0,0,0,0,0,0,0,0,0,0,0,0,0,0,0,0,0,0,0,0,0,0,0,0,0,0,0,0,0,0,0,0,0,0,0,0,0,0,0,0,0,0,0,0,0,0,0,0,0,0,0,0,0,0,0
0,0,0,0,0,0,0,0,0,0,0,0,0,0,0,0,0,0,0,0,0,0,0,0,0,0,0,0,0,0,0,0,0,0,0,0,0,0,0,0,0,0,0,0,0,0,0,0,0,0,0,0,0,0,0,0,0,0,0,0,0,0,0,0
0,0,0,0,0,0,0,0,0,0,0,0,0,0,0,0,0,0,0,0,0,0,0,0,0,0,0,0,0,0,0,0,0,0,0,0,0,0,0,0,0,0,0,0,0,0,0,0,0,0,0,0,0,0,0,0,0,0,0,0,0,0,0,0

0,0,0,0,0,0,0,0,0,0,0,0,0,0,0,0,0,0,0,0,0,0,0,0,0,0,0,0,0,0,0,0,0,0,0,0,0,0,0,0,0,0,0,0,0,0,0,0,0,0,0,0,0,0,0,0,0,0,0,0,0,0,0,0
0,0,0,0,0,0,0,0,0,0,0,0,0,0,0,0,0,0,0,0,0,0,0,0,0,0,0,0,0,0,0,0,0,0,0,0,0,0,0,0,0,0,0,0,0,0,0,0,0,0,0,0,0,0,0,0,0,0,0,0,0,0,0,0
0,0,0,0,0,0,0,0,0,0,0,0,0,0,0,0,0,0,0,0,0,0,0,0,0,0,0,0,0,0,0,0,0,0,0,0,0,0,0,0,0,0,0,0,0,0,0,0,0,0,0,0,0,0,0,0,0,0,0,0,0,0,0,0
0,0,0,0,0,0,0,0,0,0,0,0,0,0,0,0,0,0,0,0,0,0,0,0,0,9005,9005,9005,9005,9005,9005,9005,0,0,0,0,0,0,0,0,0,0,0,0,0,0,0,0,0,0,0,0,0,0,0,0,0,0,0,0,0,0,0,0
0,0,0,0,0,0,0,0,0,0,0,0,0,0,0,0,0,0,0,0,0,0,0,0,0,9005,9005,9005,9005,9005,9005,9005,0,0,0,0,0,0,0,0,0,0,0,0,0,0,9007,9007,9007,9007,9007,0,0,0,0,0,0,0,0,0,0,0,0,0
0,0,0,0,0,0,0,0,0,0,0,0,0,0,0,0,0,0,0,0,0,0,0,0,0,9005,9005,9005,9005,9005,9005,9005,0,9006,9006,9006,9006,9006,9006,9006,9006,9006,9006,9006,9006,0,9007,0,0,0,9007,0,0,0,0,0,0,0,0,0,0,0,0,0
0,0,0,0,0,0,0,0,0,0,0,0,0,0,0,0,0,0,0,0,0,0,0,0,0,9005,9005,9005,9005,9005,9005,9005,0,9006,9006,9006,9006,9006,9006,9006,9006,9006,9006,9006,9006,0,9007,0,0,0,9007,0,0,0,0,0,0,0,0,0,0,0,0,0
0,0,0,0,0,0,0,0,0,0,0,0,0,0,0,0,0,0,0,0,0,0,0,0,0,9005,9005,9005,9005,9005,9005,9005,0,9006,9006,9006,9006,9006,9006,9006,9006,9006,9006,9006,9006,0,9007,0,0,0,9007,0,0,0,0,0,0,0,0,0,0,0,0,0
0,0,0,0,0,0,0,0,0,0,0,0,0,0,0,0,0,0,0,0,0,0,0,0,0,9005,9005,9005,9005,9005,9005,9005,0,0,0,0,0,0,0,0,0,0,0,0,0,0,9007,9007,9007,9007,9007,0,0,0,0,0,0,0,0,0,0,0,0,0
0,0,0,0,0,0,0,0,0,0,0,0,0,0,0,0,0,0,0,0,0,0,0,0,0,9005,9005,9005,9005,9005,9005,9005,0,0,0,0,0,0,0,0,0,0,0,0,0,0,0,0,0,0,0,0,0,0,0,0,0,0,0,0,0,0,0,0
0,0,0,0,0,0,0,0,0,0,0,0,0,0,0,0,0,0,0,0,0,0,0,0,0,9005,9005,9005,9005,9005,9005,9005,0,0,0,0,0,0,0,0,0,0,0,0,0,0,0,0,0,0,0,0,0,0,0,0,0,0,0,0,0,0,0,0
0,0,0,0,0,0,0,0,0,0,0,0,0,0,0,0,0,0,0,0,0,0,0,0,0,9005,9005,9005,9005,9005,9005,9005,0,0,0,0,0,0,0,0,0,0,0,0,0,0,0,0,0,0,0,0,0,0,0,0,0,0,0,0,0,0,0,0
0,0,0,0,0,0,0,0,0,0,0,0,0,0,0,0,0,0,0,0,0,0,0,0,0,0,0,0,0,0,0,0,0,0,0,0,0,0,0,0,0,0,0,0,0,0,0,0,0,0,0,0,0,0,0,0,0,0,0,0,0,0,0,0
0,0,0,0,0,0,0,0,0,0,0,0,9001,9001,9001,9001,9001,9001,9001,9001,9001,9001,9001,9001,9001,9001,9001,9001,9001,9001,9001,9001,9001,9001,9001,9001,9001,9001,9001,9001,9001,9001,9001,9001,0,0,0,0,0,0,0,0,0,0,0,0,0,0,0,0,0,0,0,0
0,0,0,0,0,0,0,0,0,0,0,0,9001,9001,9001,9001,9001,9001,9001,9001,9001,9001,9001,9001,9001,9001,9001,9001,9001,9001,9001,9001,9001,9001,9001,9001,9001,9001,9001,9001,9001,9001,9001,9001,0,0,0,0,0,0,0,0,0,0,0,0,0,0,0,0,0,0,0,0
0,0,0,0,0,0,0,0,0,0,0,0,9001,9001,9001,9001,9001,9001,9001,9001,9001,9001,9001,9001,9001,9001,9001,9001,9001,9001,9001,9001,9001,9001,9001,9001,9001,9001,9001,9001,9001,9001,9001,9001,0,0,0,0,0,0,0,0,0,0,0,0,0,0,0,0,0,0,0,0
0,0,0,0,0,0,0,0,0,0,0,0,9001,9001,9001,9001,9001,9001,9001,9001,9001,9001,9001,9001,9001,9001,9001,9001,9001,9001,9001,9001,9001,9001,9001,9001,9001,9001,9001,9001,9001,9001,9001,9001,0,0,0,0,0,0,0,0,0,0,0,0,0,0,0,0,0,0,0,0
0,0,0,0,0,0,0,0,0,0,0,0,9001,9001,9001,9001,0,0,0,0,0,0,0,0,9001,9001,9001,9001,9001,9001,9001,9001,9001,0,0,0,0,0,0,0,0,9001,9001,9001,0,0,0,0,0,0,0,0,0,0,0,0,0,0,0,0,0,0,0,0
0,0,0,0,0,0,0,0,0,0,0,0,9001,9001,9001,9001,0,0,0,9008,0,0,0,0,9001,9001,9001,9001,9001,9001,9001,9001,9001,0,0,0,0,0,0,0,0,9001,9001,9001,0,0,0,0,0,0,0,0,0,0,0,0,0,0,0,0,0,0,0,0
0,0,0,0,0,0,0,0,0,0,0,0,9001,9001,9001,9001,0,0,0,9008,0,0,0,0,9001,9001,9001,9001,9001,9001,9001,9001,9001,0,0,0,0,0,0,0,0,9001,9001,9001,0,0,0,0,0,0,0,0,0,0,0,0,0,0,0,0,0,0,0,0
0,0,0,0,0,0,0,0,0,0,0,0,9001,9001,9001,9001,0,0,0,9008,9008,9008,0,0,9001,9001,9001,9001,9001,9001,9001,9001,9001,0,0,0,0,0,0,0,0,9001,9001,9001,0,0,0,0,0,0,0,0,0,0,0,0,0,0,0,0,0,0,0,0
0,0,9004,9004,9004,9004,9004,9004,9004,9004,0,0,9001,9001,9001,9001,0,0,0,9008,9008,9008,0,0,9001,9001,9001,9001,9001,9001,9001,9001,9001,0,0,0,0,0,0,0,0,9001,9001,9001,0,0,9003,9003,9003,9003,9003,9003,9003,9003,0,0,0,0,0,0,0,0,0,0
0,0,9004,9004,9004,9004,9004,9004,9004,9004,0,0,9001,9001,9001,9001,0,0,0,9008,9008,9008,0,0,9001,9001,9001,9001,9001,9001,9001,9001,9001,0,0,0,0,0,0,0,0,9001,9001,9001,0,0,9003,9003,9003,9003,9003,9003,9003,9003,0,0,0,0,0,0,0,0,0,0
0,0,9004,9004,9004,9004,9004,9004,9004,9004,9004,0,9001,9001,9001,9001,0,0,0,0,0,0,0,0,9001,9001,9001,9001,9001,9001,9001,9001,9001,0,0,0,0,0,0,0,0,9001,9001,9001,0,9003,9003,9003,9003,9003,9003,9003,9003,9003,0,0,0,0,0,0,0,0,0,0
0,0,9004,9004,9004,9004,9004,9004,9004,9004,9004,0,9001,9001,9001,9001,0,0,0,0,0,0,0,0,9001,9001,9001,9001,9001,9001,9001,9001,9001,0,0,0,0,0,0,0,0,9001,9001,9001,0,9003,9003,9003,9003,9003,9003,9003,9003,9003,0,0,0,0,0,0,0,0,0,0
0,0,9004,9004,9004,9004,9004,9004,9004,9004,9004,0,9001,9001,9001,9001,9001,9001,9001,9001,9001,9001,9001,9001,9001,9001,9001,9001,9001,9001,9001,9001,9001,9001,9001,9001,9001,9001,9001,9001,9001,9001,9001,9001,0,9003,9003,9003,9003,9003,9003,9003,9003,9003,0,0,0,0,0,0,0,0,0,0
0,0,9004,9004,9004,9004,9004,9004,9004,9004,9004,0,9001,9001,9001,9001,9001,9001,9001,9001,9001,9001,9001,9001,9001,9001,9001,9001,9001,9001,9001,9001,9001,9001,9001,9001,9001,9001,9001,9001,9001,9001,9001,9001,0,9003,9003,9003,9003,9003,9003,9003,9003,9003,0,0,0,0,0,0,0,0,0,0
0,0,9004,9004,9004,9004,9004,9004,9004,9004,9004,0,9001,9001,9001,9001,0,0,0,0,0,0,0,0,9001,9001,9001,9001,9001,9001,9001,9001,9001,0,0,0,0,0,0,0,0,9001,9001,9001,0,9003,9003,9003,9003,9003,9003,9003,9003,9003,0,0,0,0,0,0,0,0,0,0
0,0,9004,9004,9004,9004,9004,9004,9004,9004,0,0,9001,9001,9001,9001,0,0,0,0,0,0,0,0,9001,9001,9001,9001,9001,9001,9001,9001,9001,0,0,0,0,0,0,0,0,9001,9001,9001,0,0,9003,9003,9003,9003,9003,9003,9003,9003,0,0,0,0,0,0,0,0,0,0
0,0,9004,9004,9004,9004,9004,9004,9004,9004,0,0,9001,9001,9001,9001,0,0,0,0,0,0,0,0,9001,9001,9001,9001,9001,9001,9001,9001,9001,0,0,0,0,0,0,0,0,9001,9001,9001,0,0,9003,9003,9003,9003,9003,9003,9003,9003,0,0,0,0,0,0,0,0,0,0
0,0,9004,9004,9004,9004,9004,9004,9004,9004,0,0,9001,9001,9001,9001,0,0,0,0,0,0,0,0,9001,9001,9001,9001,9001,9001,9001,9001,9001,0,0,0,0,0,0,0,0,9001,9001,9001,0,0,9003,9003,9003,9003,9003,9003,9003,9003,0,0,0,0,0,0,0,0,0,0
0,0,9004,9004,9004,9004,9004,9004,9004,9004,0,0,9001,9001,9001,9001,0,0,0,0,0,0,0,0,9001,9001,9001,9001,9001,9001,9001,9001,9001,0,0,0,0,0,0,0,0,9001,9001,9001,0,0,9003,9003,9003,9003,9003,9003,9003,9003,0,0,0,0,0,0,0,0,0,0
0,0,9004,9004,9004,9004,9004,9004,9004,9004,0,0,9001,9001,9001,9001,0,0,0,0,0,0,0,0,9001,9001,9001,9001,9001,9001,9001,9001,9001,0,0,0,0,0,0,0,0,9001,9001,9001,0,0,9003,9003,9003,9003,9003,9003,9003,9003,0,0,0,0,0,0,0,0,0,0
0,0,9004,9004,9004,9004,9004,9004,9004,9004,0,0,9001,9001,9001,9001,0,0,0,0,0,0,0,0,9001,9001,9001,9001,9001,9001,9001,9001,9001,0,0,0,0,0,0,0,0,9001,9001,9001,0,0,9003,9003,9003,9003,9003,9003,9003,9003,0,0,0,0,0,0,0,0,0,0
0,0,9004,9004,9004,9004,9004,9004,9004,9004,0,0,9001,9001,9001,9001,0,0,0,0,0,0,0,0,9001,9001,9001,9001,9001,9001,9001,9001,9001,0,0,0,0,0,0,0,0,9001,9001,9001,0,0,9003,9003,9003,9003,9003,9003,9003,9003,0,0,0,0,0,0,0,0,0,0
0,0,9004,9004,9004,9004,9004,9004,9004,9004,0,0,9001,9001,9001,9001,9001,9001,9001,9001,9001,9001,9001,9001,9001,9001,9001,9001,9001,9001,9001,9001,9001,9001,9001,9001,9001,9001,9001,9001,9001,9001,9001,9001,0,0,9003,9003,9003,9003,9003,9003,9003,9003,0,0,0,0,0,0,0,0,0,0
0,0,9004,9004,9004,9004,9004,9004,9004,9004,0,0,9001,9001,9001,9001,9001,9001,9001,9001,9001,9001,9001,9001,9001,9001,9001,9001,9001,9001,9001,9001,9001,9001,9001,9001,9001,9001,9001,9001,9001,9001,9001,9001,0,0,9003,9003,9003,9003,9003,9003,9003,9003,0,0,0,0,0,0,0,0,0,0
0,0,9004,9004,9004,9004,9004,9004,9004,9004,0,0,9001,9001,9001,9001,0,0,0,0,0,0,0,0,9001,9001,9001,9001,9001,9001,9001,9001,9001,0,0,0,0,0,0,0,0,9001,9001,9001,0,0,9003,9003,9003,9003,9003,9003,9003,9003,0,0,0,0,0,0,0,0,0,0
0,0,9004,9004,9004,9004,9004,9004,9004,9004,0,0,9001,9001,9001,9001,0,0,0,9009,9009,9009,9009,0,9001,9001,9001,9001,9001,9001,9001,9001,9001,0,0,0,0,0,0,0,0,9001,9001,9001,0,0,9003,9003,9003,9003,9003,9003,9003,9003,0,0,0,0,0,0,0,0,0,0
0,0,9004,9004,9004,9004,9004,9004,9004,9004,0,0,9001,9001,9001,9001,0,0,0,9009,9009,9009,9009,0,9001,9001,9001,9001,9001,9001,9001,9001,9001,0,0,0,0,0,0,0,0,9001,9001,9001,0,0,9003,9003,9003,9003,9003,9003,9003,9003,0,0,0,0,0,0,0,0,0,0
0,0,9004,9004,9004,9004,9004,9004,9004,9004,0,0,9001,9001,9001,9001,0,0,0,9009,9009,9009,9009,0,9001,9001,9001,9001,9001,9001,9001,9001,9001,0,0,0,0,0,0,0,0,9001,9001,9001,0,0,0,0,0,0,0,0,0,0,0,0,0,0,0,0,0,0,0,0
0,0,0,0,0,0,0,0,0,0,0,0,9001,9001,9001,9001,0,9009,9009,9009,9009,9009,9009,0,9001,9001,9001,9001,9001,9001,9001,9001,9001,0,0,0,0,0,0,0,0,9001,9001,9001,0,0,0,0,0,0,0,0,0,0,0,0,0,0,0,0,0,0,0,0
0,0,0,0,0,0,0,0,0,0,0,0,9001,9001,9001,9001,0,0,0,0,0,0,0,0,9001,9001,9001,9001,9001,9001,9001,9001,9001,0,0,0,0,0,0,0,0,9001,9001,9001,0,0,0,0,0,0,0,0,0,0,0,0,0,0,0,0,0,0,0,0
0,0,0,0,0,0,0,0,0,0,0,0,9001,9001,9001,9001,0,0,0,0,0,0,0,0,9001,9001,9001,9001,9001,9001,9001,9001,9001,0,0,0,0,0,0,0,0,9001,9001,9001,0,0,0,0,0,0,0,0,0,0,0,0,0,0,0,0,0,0,0,0
0,0,0,0,0,0,0,0,0,0,0,0,9001,9001,9001,9001,9001,9001,9001,9001,9001,9001,9001,9001,9001,9001,9001,9001,9001,9001,9001,9001,9001,9001,9001,9001,9001,9001,9001,9001,9001,9001,9001,9001,0,0,0,0,0,0,0,0,0,0,0,0,0,0,0,0,0,0,0,0
0,0,0,0,0,0,0,0,0,0,0,0,0,0,0,0,0,0,0,0,0,0,0,0,0,0,0,0,0,0,0,0,0,0,0,0,0,0,0,0,0,0,0,0,0,0,0,0,0,0,0,0,0,0,0,0,0,0,0,0,0,0,0,0
0,0,0,0,0,0,0,0,0,0,0,0,0,0,0,0,0,0,0,0,0,0,0,0,0,9002,9002,9002,9002,9002,9002,9002,0,0,0,0,0,0,0,0,0,0,0,0,0,0,0,0,0,0,0,0,0,0,0,0,0,0,0,0,0,0,0,0
0,0,0,0,0,0,0,0,0,0,0,0,0,0,0,0,0,0,0,0,0,0,0,0,0,9002,9002,9002,9002,9002,9002,9002,0,0,0,0,0,0,0,0,0,0,0,0,0,0,0,0,0,0,0,0,0,0,0,0,0,0,0,0,0,0,0,0
0,0,0,0,0,0,0,0,0,0,0,0,0,0,0,0,0,0,0,0,0,0,0,0,0,9002,9002,9002,9002,9002,9002,9002,0,0,0,0,0,0,0,0,0,0,0,0,0,0,0,0,0,0,0,0,0,0,0,0,0,0,0,0,0,0,0,0
0,0,0,0,0,0,0,0,0,0,0,0,0,0,0,0,0,0,0,0,0,0,0,0,0,9002,9002,9002,9002,9002,9002,9002,0,0,0,0,0,0,0,0,0,0,0,0,0,0,0,0,0,0,0,0,0,0,0,0,0,0,0,0,0,0,0,0
0,0,0,0,0,0,0,0,0,0,0,0,0,0,0,0,0,0,0,0,0,0,0,0,0,9002,9002,9002,9002,9002,9002,9002,0,0,0,0,0,0,0,0,0,0,0,0,0,0,0,0,0,0,0,0,0,0,0,0,0,0,0,0,0,0,0,0
0,0,0,0,0,0,0,0,0,0,0,0,0,0,0,0,0,0,0,0,0,0,0,0,0,9002,9002,9002,9002,9002,9002,9002,0,0,0,0,0,0,0,0,0,0,0,0,0,0,0,0,0,0,0,0,0,0,0,0,0,0,0,0,0,0,0,0
0,0,0,0,0,0,0,0,0,0,0,0,0,0,0,0,0,0,0,0,0,0,0,0,0,9002,9002,9002,9002,9002,9002,9002,0,0,0,0,0,0,0,0,0,0,0,0,0,0,0,0,0,0,0,0,0,0,0,0,0,0,0,0,0,0,0,0
0,0,0,0,0,0,0,0,0,0,0,0,0,0,0,0,0,0,0,0,0,0,0,0,0,9002,9002,9002,9002,9002,9002,9002,0,0,0,0,0,0,0,0,0,0,0,0,0,0,0,0,0,0,0,0,0,0,0,0,0,0,0,0,0,0,0,0
0,0,0,0,0,0,0,0,0,0,0,0,0,0,0,0,0,0,0,0,0,0,0,0,0,9002,9002,9002,9002,9002,9002,9002,0,0,0,0,0,0,0,0,0,0,0,0,0,0,0,0,0,0,0,0,0,0,0,0,0,0,0,0,0,0,0,0
0,0,0,0,0,0,0,0,0,0,0,0,0,0,0,0,0,0,0,0,0,0,0,0,0,0,0,0,0,0,0,0,0,0,0,0,0,0,0,0,0,0,0,0,0,0,0,0,0,0,0,0,0,0,0,0,0,0,0,0,0,0,0,0
0,0,0,0,0,0,0,0,0,0,0,0,0,0,0,0,0,0,0,0,0,0,0,0,0,0,0,0,0,0,0,0,0,0,0,0,0,0,0,0,0,0,0,0,0,0,0,0,0,0,0,0,0,0,0,0,0,0,0,0,0,0,0,0
0,0,0,0,0,0,0,0,0,0,0,0,0,0,0,0,0,0,0,0,0,0,0,0,0,0,0,0,0,0,0,0,0,0,0,0,0,0,0,0,0,0,0,0,0,0,0,0,0,0,0,0,0,0,0,0,0,0,0,0,0,0,0,0
0,0,0,0,0,0,0,0,0,0,0,0,0,0,0,0,0,0,0,0,0,0,0,0,0,0,0,0,0,0,0,0,0,0,0,0,0,0,0,0,0,0,0,0,0,0,0,0,0,0,0,0,0,0,0,0,0,0,0,0,0,0,0,0
0,0,0,0,0,0,0,0,0,0,0,0,0,0,0,0,0,0,0,0,0,0,0,0,0,0,0,0,0,0,0,0,0,0,0,0,0,0,0,0,0,0,0,0,0,0,0,0,0,0,0,0,0,0,0,0,0,0,0,0,0,0,0,0
0,0,0,0,0,0,0,0,0,0,0,0,0,0,0,0,0,0,0,0,0,0,0,0,0,0,0,0,0,0,0,0,0,0,0,0,0,0,0,0,0,0,0,0,0,0,0,0,0,0,0,0,0,0,0,0,0,0,0,0,0,0,0,0
0,0,0,0,0,0,0,0,0,0,0,0,0,0,0,0,0,0,0,0,0,0,0,0,0,0,0,0,0,0,0,0,0,0,0,0,0,0,0,0,0,0,0,0,0,0,0,0,0,0,0,0,0,0,0,0,0,0,0,0,0,0,0,0
0,0,0,0,0,0,0,0,0,0,0,0,0,0,0,0,0,0,0,0,0,0,0,0,0,0,0,0,0,0,0,0,0,0,0,0,0,0,0,0,0,0,0,0,0,0,0,0,0,0,0,0,0,0,0,0,0,0,0,0,0,0,0,0
0,0,0,0,0,0,0,0,0,0,0,0,0,0,0,0,0,0,0,0,0,0,0,0,0,0,0,0,0,0,0,0,0,0,0,0,0,0,0,0,0,0,0,0,0,0,0,0,0,0,0,0,0,0,0,0,0,0,0,0,0,0,0,0
