64
1001
1001
0,1024,1024,1024,1024,1024,1024,1024,1024,1024,1024,1024,1024,1024,1024,1024,1024,1024,1024,1024,1024,1024,1024,1024,1024,1024,1024,1024,1024,1024,1024,1024,1024,1024,1024,1024,1024,1024,1024,1024,1024,1024,1024,1024,1024,1024,1024,1024,1024,1024,1024,1024,1024,1024,1024,1024,1024,1024,1024,1024,1024,0,0,0
0,1024,0,0,0,0,0,0,0,0,0,0,0,0,0,0,0,0,1024,0,0,0,0,0,0,0,0,0,0,0,0,0,0,0,0,0,0,0,0,0,0,0,0,0,0,0,0,0,0,0,0,0,0,0,0,0,0,0,0,0,1024,0,0,0
0,1024,0,2036,0,0,0,0,0,0,0,0,0,0,0,0,2034,0,3001,0,2036,0,0,0,0,0,0,0,0,0,0,0,0,0,0,0,0,0,0,0,0,0,0,0,0,0,0,0,0,0,0,0,0,0,0,0,0,0,2034,0,1024,0,0,0
0,1024,0,2006,0,0,0,0,0,0,0,0,0,0,0,0,2005,0,1024,0,2033,0,0,0,0,0,0,0,0,2015,0,0,0,0,0,0,0,0,0,0,0,0,0,0,0,0,0,0,0,0,0,0,0,0,0,2036,0,0,0,0,1024,0,0,0
0,1024,0,2033,0,0,0,0,0,0,0,0,0,0,0,0,2035,0,1024,0,0,0,0,0,0,0,0,0,0,0,0,0,0,0,0,0,0,0,0,0,0,0,0,0,0,0,0,0,0,0,0,0,0,0,0,0,0,0,0,0,1024,0,0,0
0,1024,0,0,0,0,0,0,0,0,0,0,0,0,0,0,0,0,1024,1024,1024,1024,1024,1024,1024,1024,1024,1024,1024,1024,1024,1024,1024,1024,1024,1024,1024,1024,1024,1024,1024,1024,1024,1024,1024,1024,1024,1024,1024,1024,1024,1024,1024,1024,0,0,0,0,0,0,1024,0,0,0
0,1024,1024,1024,1024,1024,1024,1024,1024,3002,1024,1024,1024,1024,1024,1024,1024,1024,1024,0,0,0,0,0,0,1024,0,0,0,0,0,0,0,0,0,0,0,0,0,0,0,0,0,0,0,0,0,0,0,0,0,0,0,1024,0,0,0,0,0,0,1024,0,0,0
0,1024,0,0,0,0,0,0,0,0,0,0,0,0,0,0,0,0,1024,0,0,0,0,0,0,1024,0,0,0,0,0,0,0,0,0,0,0,0,0,0,0,0,0,0,0,0,0,0,0,0,0,0,0,1024,0,0,0,0,0,0,1024,0,0,0
0,1024,0,0,0,0,0,0,0,0,0,0,0,0,0,0,0,0,3001,0,0,0,0,0,0,3001,0,0,0,0,0,0,0,0,2004,0,0,0,0,0,0,0,0,0,0,0,0,0,0,0,0,0,0,1024,0,0,0,0,0,0,1024,0,0,0
0,1024,0,0,0,0,0,0,0,2017,0,0,0,0,0,0,0,0,1024,0,0,0,0,0,0,1024,0,0,0,0,0,0,0,0,0,0,0,0,0,0,0,0,0,0,0,0,0,0,0,0,0,0,0,1024,0,0,0,0,0,0,1024,0,0,0
0,1024,0,0,0,0,0,0,0,0,0,0,0,0,0,0,0,0,1024,0,0,0,0,0,0,1024,1024,1024,1024,1024,1024,1024,1024,1024,1024,1024,1024,1024,1024,1024,1024,1024,1024,1024,1024,1024,1024,1024,0,0,0,0,0,1024,0,0,0,0,0,0,1024,0,0,0
0,1024,1024,1024,1024,1024,1024,1024,1024,1024,1024,1024,1024,1024,1024,1024,1024,1024,1024,0,0,0,0,0,0,1024,0,0,0,0,4003,1024,0,0,0,0,0,1024,4007,0,0,0,0,0,0,0,0,0,0,0,0,0,0,1024,0,0,0,0,2013,0,1024,0,0,0
0,1024,4002,4007,0,0,0,0,0,0,0,0,0,0,0,0,4007,4002,1024,0,0,0,0,0,0,1024,0,0,0,0,0,1024,0,0,0,0,0,1024,0,0,0,0,0,0,0,0,0,0,0,0,0,0,0,1024,0,0,0,0,0,0,1024,0,0,0
0,1024,4002,4007,0,0,0,0,0,0,0,0,0,0,0,0,4007,4002,1024,0,0,0,0,0,0,1024,4008,0,0,0,0,3001,0,0,2025,0,0,3001,0,0,0,0,0,0,0,0,0,0,0,0,0,0,0,1024,0,0,0,0,0,0,1024,0,0,0
0,1024,4002,4007,0,0,0,0,0,0,0,0,0,0,0,0,4007,4002,1024,0,0,0,0,0,0,1024,0,0,0,0,0,1024,0,0,0,0,0,1024,0,0,0,0,0,0,0,0,0,0,0,0,0,0,0,1024,0,0,0,0,0,0,1024,0,0,0
0,1024,4002,4007,0,0,0,0,0,0,0,0,0,0,0,0,4007,4002,1024,0,0,0,0,0,0,1024,0,0,0,0,4007,1024,0,0,0,0,0,1024,4002,0,0,0,0,0,0,0,0,0,0,0,0,0,0,1024,0,0,0,0,0,0,1024,0,0,0
0,1024,1024,1024,1024,1024,1024,1024,1024,3002,1024,1024,1024,1024,1024,1024,1024,1024,1024,1024,1024,1024,1024,1024,1024,1024,1024,1024,1024,1024,1024,1024,1024,1024,1024,1024,1024,1024,1024,1024,1024,1024,1024,1024,1024,1024,1024,1024,1024,1024,1024,1024,1024,1024,0,0,0,0,0,0,1024,0,0,0
1029,1029,1029,1029,1029,1029,1029,1029,0,0,0,1029,1029,1029,1029,1029,1029,1029,1029,1029,1029,1029,1029,1029,1029,1029,1029,1029,1029,1029,1029,1029,1029,1029,1029,1029,1029,1029,1029,1024,0,0,0,0,0,0,0,0,0,0,0,0,0,0,0,0,0,0,0,0,1024,0,0,0
1029,0,2036,0,0,0,0,0,0,0,0,0,0,0,0,0,0,0,2034,0,1029,0,2036,0,0,0,0,0,0,0,0,0,0,0,0,0,0,2034,0,1024,0,2036,0,0,0,0,0,0,0,0,0,0,0,0,0,2034,0,0,0,0,1024,0,0,0
1029,0,0,0,0,0,0,0,0,0,0,0,0,0,0,0,0,0,2005,0,1029,0,2006,0,0,0,0,0,0,0,0,0,0,0,0,0,0,0,0,3005,0,0,0,0,0,0,0,0,0,0,0,0,0,0,0,0,0,0,0,0,1024,0,0,0
1029,0,0,0,0,0,0,0,0,0,0,0,0,0,0,0,0,0,0,0,3003,0,0,0,0,0,0,0,0,0,0,0,0,0,0,0,0,0,0,1024,0,2033,0,0,0,0,0,0,0,0,0,2015,0,0,0,0,0,0,2035,0,1024,0,0,0
1029,0,0,0,0,2033,0,0,0,0,0,0,0,0,0,0,0,0,2035,0,1029,0,2033,0,0,0,0,0,0,0,0,0,0,0,2036,0,0,0,1029,1024,0,0,0,0,0,0,0,0,0,0,0,0,0,0,0,0,0,0,0,0,1024,0,0,0
1029,0,2006,0,0,0,0,0,0,0,0,0,0,0,0,0,0,0,0,0,1029,0,0,0,0,0,0,0,0,0,0,0,0,0,0,0,0,0,1029,1024,1024,1024,1024,1024,1024,1024,1024,1024,1024,1024,1024,1024,1024,1024,1024,1024,1024,1024,1024,1024,1024,0,0,0
1029,0,0,0,0,0,0,1029,1029,1029,1029,1029,1029,1029,1029,1029,1029,1029,1029,1029,1029,1029,1029,1029,1029,1029,1029,1029,1029,1029,1029,1029,1029,0,0,0,0,0,1029,1029,0,0,0,0,0,0,0,0,0,0,0,0,0,0,0,0,0,0,0,0,0,0,0,0
1029,0,0,0,0,0,0,1029,0,0,0,0,0,0,0,0,0,0,0,0,0,0,0,0,0,0,0,0,0,0,0,0,1029,0,0,0,0,0,1029,1029,0,0,0,0,0,0,0,0,0,0,0,0,0,0,0,0,0,0,0,0,0,0,0,0
1029,0,0,0,0,0,0,1029,0,0,0,0,0,0,0,0,0,0,0,0,1001,1001,1001,1001,1001,1001,1001,0,0,0,0,0,1029,0,0,0,0,2005,1029,1029,0,0,0,0,0,0,0,0,0,0,0,0,0,0,0,0,0,0,0,0,0,0,0,0
1029,0,0,0,0,0,0,1029,0,0,0,0,0,0,0,0,0,0,0,0,1001,0,0,2017,0,0,1001,0,0,0,0,0,1029,0,0,0,0,0,1029,1029,0,0,0,0,0,0,0,0,0,0,0,0,0,0,0,0,0,0,0,0,0,0,0,0
1029,0,0,0,0,0,0,1029,0,0,0,0,0,0,0,0,0,0,0,0,1001,0,0,0,0,0,1001,0,0,0,0,0,1029,0,2033,0,0,2035,1029,1029,0,0,0,0,0,0,0,0,0,0,0,0,0,0,0,0,0,0,0,0,0,0,0,0
1029,0,0,0,0,0,0,1029,0,0,0,0,0,0,0,0,0,0,0,0,1001,4003,0,0,0,4007,1001,0,0,0,0,0,1029,0,0,0,0,0,1029,1029,0,0,0,0,0,0,0,0,0,0,0,0,0,0,0,0,0,0,0,0,0,0,0,0
1029,0,0,0,0,0,0,1029,0,0,0,0,0,0,1001,1001,1001,1001,1001,1001,1001,1001,1001,3002,1001,1001,1001,1001,1001,1001,1001,1001,1001,1029,1029,3002,1029,1029,1029,1026,1026,1026,1026,1026,1026,1026,1026,1026,1026,1026,1026,1026,1026,1026,1026,1026,1026,1026,1026,1026,1026,0,0,0
1029,0,0,0,0,0,0,1029,0,0,0,0,0,0,1001,0,0,0,0,0,1001,0,0,0,0,0,1001,0,2006,2038,0,0,1001,1001,0,0,0,0,1001,1026,0,0,0,0,1026,0,2036,0,0,0,0,0,0,0,0,0,0,2034,0,4002,1026,0,0,0
1029,0,0,0,0,0,0,1029,0,0,0,0,0,0,1001,0,2036,0,2034,0,1001,0,0,0,0,0,1001,0,2037,0,2038,0,1001,1001,2036,0,0,2034,1001,1026,0,0,2010,0,3001,0,2022,0,0,0,0,0,0,0,0,0,0,2021,0,4009,1026,0,0,0
1029,0,0,0,0,0,0,1029,0,0,0,0,0,0,1001,0,0,0,0,0,3001,0,0,0,0,0,3001,2037,0,0,0,2036,1001,1001,0,0,0,0,1001,1026,0,0,0,0,1026,0,2033,0,0,0,0,0,0,0,0,0,0,2035,0,4002,1026,0,0,0
1029,0,0,0,0,2005,0,1029,0,0,0,0,0,0,1001,0,2014,0,0,0,1001,0,0,0,0,0,1001,0,0,0,0,0,1001,1001,0,0,0,0,1001,1026,0,0,0,0,1026,1026,1026,1026,1026,1026,1026,1026,1026,1026,1026,1026,1026,1026,1026,1026,1026,0,0,0
1029,0,0,0,0,0,0,1029,0,0,0,0,0,0,1001,0,0,4001,0,0,1001,0,0,0,0,0,1001,0,0,4007,0,0,1001,1001,0,0,0,0,1001,1026,0,0,0,0,1026,0,0,0,0,0,0,0,0,0,0,0,0,0,0,0,1026,0,0,0
1029,0,0,0,0,0,0,1029,0,0,0,0,0,0,1001,0,0,0,0,0,1001,0,0,0,0,0,1001,0,0,0,0,0,1001,1001,0,0,0,0,1001,1026,0,0,0,0,3001,0,0,0,0,0,0,0,0,0,0,0,0,0,0,0,1026,0,0,0
1029,0,0,0,0,0,0,1029,0,0,0,0,0,0,1001,0,0,0,2005,0,1001,0,0,0,0,0,1001,2035,0,0,0,2040,1001,1001,0,0,0,0,1001,1026,0,0,0,0,1026,0,0,0,0,0,0,0,0,0,0,0,0,0,0,0,1026,0,0,0
1029,0,0,0,0,0,0,1029,0,0,0,0,0,0,1001,0,2033,0,2035,0,3001,0,0,0,0,0,3001,0,2039,0,2040,0,1001,1001,0,0,0,0,1001,1026,4002,0,0,4007,1026,0,0,0,0,0,0,0,0,0,0,0,0,0,0,0,1026,0,0,0
1029,0,0,0,0,0,0,1029,0,0,0,0,0,0,1001,0,0,0,0,0,1001,0,0,0,0,0,1001,0,0,2039,0,0,1001,1001,0,0,0,0,1001,1026,1026,1026,1026,1026,1026,1026,1026,1026,1026,3002,1026,1026,1026,1026,1026,1026,1026,1026,1026,1026,1026,0,0,0
1029,0,2033,0,0,2035,0,1029,1029,1029,1029,1001,1001,1001,1001,1001,1001,1001,1001,1001,1001,0,0,0,0,0,1001,1001,1001,1001,1001,1001,1001,1001,0,0,0,0,1001,1026,0,0,0,0,0,0,0,0,0,0,0,0,0,0,0,1026,0,2041,0,0,1026,0,0,0
1029,0,0,0,0,0,0,1029,1001,1001,1001,1001,0,0,0,0,0,0,0,0,0,0,0,0,0,0,0,0,0,0,0,0,1001,0,0,0,0,0,1001,1026,0,0,0,0,0,0,0,0,0,0,0,0,0,0,0,1026,0,0,0,0,1026,0,0,0
1029,0,2017,0,2017,0,0,1029,1001,2002,0,1001,0,2036,0,0,0,0,0,0,0,0,0,0,0,0,0,0,0,0,2034,0,1001,0,0,0,0,0,1001,1026,0,0,0,0,0,0,0,0,0,0,0,0,0,0,0,1026,0,0,0,0,1026,0,0,0
1029,1029,1029,3002,1029,1029,1029,1029,1001,0,0,1001,0,0,0,0,0,0,0,0,0,0,0,0,0,0,0,0,0,0,0,0,1001,0,0,0,0,0,1001,1026,0,0,0,0,0,0,0,0,0,0,0,0,0,0,0,1026,1026,3002,1026,1026,1026,0,0,0
1029,0,0,0,0,0,2003,1029,1001,0,0,3001,0,0,0,0,0,0,0,0,0,0,0,0,0,0,0,0,0,0,0,0,3001,0,0,0,0,2013,1001,1026,1026,1026,1026,3002,1026,1026,1026,1026,1026,1026,1026,1026,1026,1026,1026,1026,4007,0,0,4007,1026,0,0,0
1029,0,0,2025,0,0,0,1029,1001,0,0,1001,0,2033,2015,0,0,0,0,0,0,0,0,0,0,0,0,0,0,0,2035,0,1001,0,0,0,0,0,1001,1026,0,0,0,0,0,0,0,0,0,0,0,0,0,0,0,1026,4003,0,0,4003,1026,0,0,0
1029,0,1012,3002,1012,0,0,1029,1001,0,0,1001,1001,1001,1001,1001,1001,1001,1001,1001,1001,1001,0,0,0,0,0,1001,1001,1001,1001,1001,1001,1001,0,0,0,0,1001,1026,0,0,0,0,0,0,0,0,0,0,0,0,0,0,0,1026,0,0,0,0,1026,0,0,0
1029,0,1012,4011,1012,0,0,1029,1001,0,0,1001,1001,1001,1001,1001,1026,1026,1026,1026,1026,1026,1026,1026,3002,1026,1026,1026,1026,1026,1026,1026,1026,1001,0,0,0,0,1001,1026,0,0,0,0,0,0,0,0,0,0,0,0,0,0,0,1026,0,0,0,0,1026,0,0,0
1029,1029,1012,1012,1012,1029,1029,1029,1001,0,0,0,0,0,0,1001,1026,0,2002,0,0,1026,4002,0,0,0,4002,1026,0,0,2002,0,1026,1001,0,0,0,0,1001,1026,1026,1026,1026,1026,1026,1026,1026,1026,1026,3002,1026,1026,1026,1026,1026,1026,1026,3002,1026,1026,1026,0,0,0
0,0,0,0,0,0,0,1029,1001,0,0,0,0,0,0,1001,1026,0,0,0,0,1026,0,0,0,0,0,1026,0,0,0,0,1026,1001,0,0,0,0,1001,1026,4003,4003,4007,4007,1026,0,0,0,0,0,0,0,0,0,0,0,0,0,0,0,1026,0,0,0
0,0,0,0,0,0,0,1029,1001,1001,1001,1001,0,0,0,1001,1026,0,0,0,0,1026,0,0,0,0,0,1026,0,0,0,0,1026,1001,2014,0,0,0,1001,1026,0,0,0,0,1026,0,0,0,0,0,0,0,0,0,0,0,0,0,0,0,1026,0,0,0
1017,1017,1017,1017,1017,1017,1017,1017,1017,1017,1017,1017,1017,3002,1017,1017,1026,0,0,0,4001,1026,0,0,0,0,0,1026,4001,0,0,0,1026,1001,0,0,0,0,1001,1026,0,0,0,0,3001,0,0,0,0,0,0,0,0,0,0,0,0,0,0,0,1026,0,0,0
1017,2036,2036,1017,0,0,0,1017,0,2002,0,1017,0,0,0,1017,1026,1026,3002,1026,1026,1026,0,0,0,0,0,1026,1026,1026,3002,1026,1026,1001,0,0,0,0,1001,1026,0,0,0,0,1026,0,0,0,0,0,0,0,0,0,0,0,0,0,0,0,1026,0,0,0
1017,2006,0,1017,0,4002,0,1017,0,0,0,1017,0,0,0,1017,1026,0,0,0,0,1026,0,0,0,0,0,1026,0,0,0,0,1026,1001,0,0,0,0,1001,1026,1026,3002,1026,1026,1026,1026,1026,1026,1026,1026,1026,1026,3002,1026,1026,1026,1026,1026,1026,1026,1026,0,0,0
1017,0,0,1017,0,0,0,1017,0,0,0,1017,0,0,0,1017,1026,0,0,0,0,1026,0,0,0,0,0,1026,0,0,0,0,1026,1001,0,0,0,0,1001,1026,0,0,0,0,1026,0,0,0,0,0,0,0,0,0,0,0,0,0,0,0,1026,0,0,0
1017,0,0,1017,1017,3002,1017,1017,1017,3002,1017,1017,0,0,0,1017,1026,0,0,0,0,1026,0,0,0,0,0,1026,0,0,0,0,1026,1001,0,0,0,0,1001,1026,0,0,0,0,1026,0,0,0,0,0,0,0,0,0,0,0,0,0,0,0,1026,0,0,0
1017,0,0,0,0,0,0,0,0,0,0,1017,0,0,0,1017,1026,0,0,0,2004,1026,0,0,0,0,0,1026,2003,0,0,0,1026,1001,0,0,0,0,1001,1026,0,2041,0,0,1026,0,0,0,0,0,0,0,0,0,0,0,0,0,0,0,1026,0,0,0
1017,0,0,0,0,0,0,0,0,0,0,3001,0,0,0,1017,1026,1026,3002,1026,1026,1026,0,0,0,0,0,1026,1026,1026,3002,1026,1026,1001,0,0,0,0,1001,1026,1026,1026,1026,1026,1026,1026,1026,1026,1026,1026,1026,1026,3002,1026,1026,1026,1026,1026,1026,1026,1026,0,0,0
1017,0,0,0,0,0,0,0,0,0,0,1017,0,0,0,1017,1026,0,0,0,0,1026,0,0,0,0,0,1026,0,0,0,0,1026,1001,0,0,0,0,1001,1001,1001,1001,1001,1001,1001,1001,1001,1001,1001,1001,0,0,0,0,0,0,1001,1001,1001,1001,1001,0,0,0
1017,0,0,1017,1017,3002,1017,1017,1017,3002,1017,1017,0,0,0,1017,1026,0,0,0,0,1026,1026,1026,3002,1026,1026,1026,0,0,0,0,1026,1001,0,0,0,2035,0,0,0,0,0,0,0,0,0,0,0,0,0,0,0,0,0,0,0,0,2034,0,1001,0,0,0
1017,0,0,1017,0,0,0,1017,0,0,0,1017,0,0,0,1017,1026,0,0,0,0,1026,0,0,0,0,0,1026,0,0,0,0,1026,1001,0,0,0,0,0,0,0,0,0,0,0,0,0,0,0,0,0,0,0,0,0,0,0,0,0,0,1001,0,0,0
1017,0,2005,1017,0,4007,0,1017,0,4002,0,1017,0,0,0,1017,1026,0,0,0,0,3001,0,0,0,0,0,3001,0,0,0,0,1026,1001,2033,0,0,0,0,0,0,0,0,0,0,2015,0,0,0,0,0,0,0,0,0,0,0,0,2035,0,1001,0,0,0
1017,2035,2035,1017,0,0,0,1017,0,0,0,1017,0,4010,0,1017,1026,0,0,0,0,1026,0,0,2009,0,0,1026,0,0,0,0,1026,1001,0,0,0,0,0,0,0,0,0,0,0,0,0,0,0,0,0,0,0,0,0,0,0,0,0,0,1001,0,0,0
1017,1017,1017,1017,1017,1017,1017,1017,1017,1017,1017,1017,1017,1017,1017,1017,1026,1026,1026,1026,1026,1026,1026,1026,1026,1026,1026,1026,1026,1026,1026,1026,1026,1001,1001,1001,1001,1001,1001,1001,1001,1001,1001,1001,1001,1001,1001,1001,1001,1001,1001,1001,1001,1001,1001,1001,1001,1001,1001,1001,1001,0,0,0
0,0,0,0,0,0,0,0,0,0,0,0,0,0,0,0,0,0,0,0,0,0,0,0,0,0,0,0,0,0,0,0,0,0,0,0,0,0,0,0,0,0,0,0,0,0,0,0,0,0,0,0,0,0,0,0,0,0,0,0,0,0,0,0

0,0,0,0,0,0,0,0,0,0,0,0,0,0,0,0,0,0,0,0,0,0,0,0,0,0,0,0,0,0,0,0,0,0,0,0,0,0,0,0,0,0,0,0,0,0,0,0,0,0,0,0,0,0,0,0,0,0,0,0,0,0,0,0
0,0,9030,9030,9030,9030,9030,9030,9030,9030,9030,9030,9030,9030,9030,9030,9030,9030,0,9029,9029,9029,9029,9029,9029,9029,9029,9029,9029,9029,9029,9029,9029,9029,9029,9029,9029,9029,9029,9029,9029,9029,9029,9029,9029,9029,9029,9029,9029,9029,9029,9029,9029,9029,9029,9029,9029,9029,9029,9029,0,0,0,0
0,0,9030,9030,9030,9030,9030,9030,9030,9030,9030,9030,9030,9030,9030,9030,9030,9030,0,9029,9029,9029,9029,9029,9029,9029,9029,9029,9029,9029,9029,9029,9029,9029,9029,9029,9029,9029,9029,9029,9029,9029,9029,9029,9029,9029,9029,9029,9029,9029,9029,9029,9029,9029,9029,9029,9029,9029,9029,9029,0,0,0,0
0,0,9030,9030,9030,9030,9030,9030,9030,9030,9030,9030,9030,9030,9030,9030,9030,9030,0,9029,9029,9029,9029,9029,9029,9029,9029,9029,9029,9029,9029,9029,9029,9029,9029,9029,9029,9029,9029,9029,9029,9029,9029,9029,9029,9029,9029,9029,9029,9029,9029,9029,9029,9029,9029,9029,9029,9029,9029,9029,0,0,0,0
0,0,9030,9030,9030,9030,9030,9030,9030,9030,9030,9030,9030,9030,9030,9030,9030,9030,0,9029,9029,9029,9029,9029,9029,9029,9029,9029,9029,9029,9029,9029,9029,9029,9029,9029,9029,9029,9029,9029,9029,9029,9029,9029,9029,9029,9029,9029,9029,9029,9029,9029,9029,9029,9029,9029,9029,9029,9029,9029,0,0,0,0
0,0,9030,9030,9030,9030,9030,9030,9030,9030,9030,9030,9030,9030,9030,9030,9030,9030,0,0,0,0,0,0,0,0,0,0,0,0,0,0,0,0,0,0,0,0,0,0,0,0,0,0,0,0,0,0,9029,0,0,0,0,0,9029,9029,9029,9029,9029,9029,0,0,0,0
0,0,0,0,0,0,0,0,0,0,0,0,0,0,0,0,0,0,0,9032,9032,9032,9032,9032,9032,0,9033,9033,9033,9033,9033,9033,9033,9033,9033,9033,9033,9033,9033,9033,9033,9033,9033,9033,9033,9033,9033,9033,9033,9033,9033,9033,9033,0,9029,9029,9029,9029,9029,9029,0,0,0,0
0,0,9031,9031,9031,9031,9031,9031,9031,9031,9031,9031,9031,9031,9031,9031,9031,9031,0,9032,9032,9032,9032,9032,9032,0,9033,9033,9033,9033,9033,9033,9033,9033,9033,9033,9033,9033,9033,9033,9033,9033,9033,9033,9033,9033,9033,9033,9033,9033,9033,9033,9033,0,9029,9029,9029,9029,9029,9029,0,0,0,0
0,0,9031,9031,9031,9031,9031,9031,9031,9031,9031,9031,9031,9031,9031,9031,9031,9031,0,9032,9032,9032,9032,9032,9032,0,9033,9033,9033,9033,9033,9033,9033,9033,9033,9033,9033,9033,9033,9033,9033,9033,9033,9033,9033,9033,9033,9033,9033,9033,9033,9033,9033,0,9029,9029,9029,9029,9029,9029,0,0,0,0
0,0,9031,9031,9031,9031,9031,9031,9031,9031,9031,9031,9031,9031,9031,9031,9031,9031,0,9032,9032,9032,9032,9032,9032,0,9033,9033,9033,9033,9033,9033,9033,9033,9033,9033,9033,9033,9033,9033,9033,9033,9033,9033,9033,9033,9033,9033,9033,9033,9033,9033,9033,0,9029,9029,9029,9029,9029,9029,0,0,0,0
0,0,9031,9031,9031,9031,9031,9031,9031,9031,9031,9031,9031,9031,9031,9031,9031,9031,0,9032,9032,9032,9032,9032,9032,0,0,0,0,0,0,0,0,0,0,0,0,0,0,0,0,0,0,0,0,0,0,0,9033,9033,9033,9033,9033,0,9029,9029,9029,9029,9029,9029,0,0,0,0
0,0,0,0,0,0,0,0,0,0,0,0,0,0,0,0,0,0,0,9032,9032,9032,9032,9032,9032,0,9035,9035,9035,9035,9035,0,9034,9034,9034,9034,9034,0,9033,9033,9033,9033,9033,9033,9033,9033,9033,9033,9033,9033,9033,9033,9033,0,9029,9029,9029,9029,9029,9029,0,0,0,0
0,0,9037,9037,9037,9037,9037,9037,9037,9037,9037,9037,9037,9037,9037,9037,9037,9037,0,9032,9032,9032,9032,9032,9032,0,9035,9035,9035,9035,9035,0,9034,9034,9034,9034,9034,0,9033,9033,9033,9033,9033,9033,9033,9033,9033,9033,9033,9033,9033,9033,9033,0,9029,9029,9029,9029,9029,9029,0,0,0,0
0,0,9037,9037,9037,9037,9037,9037,9037,9037,9037,9037,9037,9037,9037,9037,9037,9037,0,9032,9032,9032,9032,9032,9032,0,9035,9035,9035,9035,9035,0,9034,9034,9034,9034,9034,0,9033,9033,9033,9033,9033,9033,9033,9033,9033,9033,9033,9033,9033,9033,9033,0,9029,9029,9029,9029,9029,9029,0,0,0,0
0,0,9037,9037,9037,9037,9037,9037,9037,9037,9037,9037,9037,9037,9037,9037,9037,9037,0,9032,9032,9032,9032,9032,9032,0,9035,9035,9035,9035,9035,0,9034,9034,9034,9034,9034,0,9033,9033,9033,9033,9033,9033,9033,9033,9033,9033,9033,9033,9033,9033,9033,0,9029,0,9029,9029,9029,9029,0,0,0,0
0,0,9037,9037,9037,9037,9037,9037,9037,9037,9037,9037,9037,9037,9037,9037,9037,9037,0,9032,9032,9032,9032,9032,9032,0,9035,9035,9035,9035,9035,0,9034,9034,9034,9034,9034,0,9033,9033,9033,9033,9033,9033,9033,9033,9033,9033,9033,9033,9033,9033,9033,0,9029,9029,9029,9029,9029,9029,0,0,0,0
0,0,0,0,0,0,0,0,0,0,0,0,0,0,0,0,0,0,0,0,0,0,0,0,0,0,0,0,0,0,0,0,0,0,0,0,0,0,0,0,0,0,0,0,0,0,0,0,0,0,0,0,0,0,9029,9029,9029,9029,9029,9029,0,0,0,0
0,0,0,0,0,0,0,0,9036,9036,9036,0,0,0,0,0,0,0,0,0,0,0,0,0,0,0,0,0,0,0,0,0,0,0,0,0,0,0,0,0,9029,9029,9029,9029,9029,9029,9029,9029,9029,9029,9029,9029,9029,9029,9029,9029,9029,9029,9029,9029,0,0,0,0
0,9036,9036,9036,9036,9036,9036,9036,9036,9036,9036,9036,9036,9036,9036,9036,9036,9036,9036,9036,0,9028,9028,9028,9028,9028,9028,9028,9028,9028,9028,9028,9028,9028,9028,9028,9028,9028,9028,0,9029,9029,9029,9029,9029,9029,9029,9029,9029,9029,9029,9029,9029,9029,9029,9029,9029,9029,9029,9029,0,0,0,0
0,9036,9036,9036,9036,9036,9036,9036,9036,9036,9036,9036,9036,9036,9036,9036,9036,9036,9036,9036,0,9028,9028,9028,9028,9028,9028,9028,9028,9028,9028,9028,9028,9028,9028,9028,9028,9028,9028,0,9029,9029,9029,9029,9029,9029,9029,9029,9029,9029,9029,9029,9029,9029,9029,9029,9029,9029,9029,9029,0,0,0,0
0,9036,9036,9036,9036,9036,9036,9036,9036,9036,9036,9036,9036,9036,9036,9036,9036,9036,9036,9036,0,9028,9028,9028,9028,9028,9028,9028,9028,9028,9028,9028,9028,9028,9028,9028,9028,9028,9028,0,9029,9029,9029,9029,9029,9029,9029,9029,9029,9029,9029,9029,9029,9029,9029,9029,9029,9029,9029,9029,0,0,0,0
0,9036,9036,9036,9036,9036,9036,9036,9036,9036,9036,9036,9036,9036,9036,9036,9036,9036,9036,9036,0,9028,9028,9028,9028,9028,9028,9028,9028,9028,9028,9028,9028,9028,9028,9028,9028,9028,9028,0,9029,9029,9029,9029,9029,9029,9029,9029,9029,9029,9029,9029,9029,9029,9029,9029,9029,9029,9029,9029,0,0,0,0
0,9036,9036,9036,9036,9036,9036,9036,9036,9036,9036,9036,9036,9036,9036,9036,9036,9036,9036,9036,0,9028,9028,9028,9028,9028,9028,9028,9028,9028,9028,9028,9028,9028,9028,9028,9028,9028,9028,0,0,0,0,0,0,0,0,0,0,0,0,0,0,0,0,0,0,0,0,0,0,0,0,0
0,9036,9036,9036,9036,9036,9036,0,0,0,0,0,0,0,0,0,0,0,0,0,0,0,0,0,0,0,0,0,0,0,0,0,0,9028,9028,9028,9028,9028,9028,0,0,0,0,0,0,0,0,0,0,0,0,0,0,0,0,0,0,0,0,0,0,0,0,0
0,9036,9036,9036,9036,9036,9036,0,0,0,0,0,0,0,0,0,0,0,0,0,0,0,0,0,0,0,0,0,0,0,0,0,0,9028,9028,9028,9028,9028,9028,0,0,0,0,0,0,0,0,0,0,0,0,0,0,0,0,0,0,0,0,0,0,0,0,0
0,9036,9036,9036,9036,9036,9036,0,0,0,0,0,0,0,0,0,0,0,0,0,0,0,0,0,0,0,0,0,0,0,0,0,0,9028,9028,9028,9028,9028,9028,0,0,0,0,0,0,0,0,0,0,0,0,0,0,0,0,0,0,0,0,0,0,0,0,0
0,9036,9036,9036,9036,9036,9036,0,0,0,0,0,0,0,0,0,0,0,0,0,0,9007,9007,9007,9007,9007,0,0,0,0,0,0,0,9028,9028,9028,9028,9028,9028,0,0,0,0,0,0,0,0,0,0,0,0,0,0,0,0,0,0,0,0,0,0,0,0,0
0,9036,9036,9036,9036,9036,9036,0,0,0,0,0,0,0,0,0,0,0,0,0,0,9007,9007,9007,9007,9007,0,0,0,0,0,0,0,9028,9028,9028,9028,9028,9028,0,0,0,0,0,0,0,0,0,0,0,0,0,0,0,0,0,0,0,0,0,0,0,0,0
0,9036,9036,9036,9036,9036,9036,0,0,0,0,0,0,0,0,0,0,0,0,0,0,9007,9007,9007,9007,9007,0,0,0,0,0,0,0,9028,9028,9028,9028,9028,9028,0,0,0,0,0,0,0,0,0,0,0,0,0,0,0,0,0,0,0,0,0,0,0,0,0
0,9036,9036,9036,9036,9036,9036,0,0,0,0,0,0,0,0,0,0,0,0,0,0,0,0,0,0,0,0,0,0,0,0,0,0,0,0,0,0,0,0,0,0,0,0,0,0,0,0,0,0,0,0,0,0,0,0,0,0,0,0,0,0,0,0,0
0,9036,9036,9036,9036,9036,9036,0,0,0,0,0,0,0,0,9005,9005,9005,9005,9005,0,9004,9004,9004,9004,9004,0,9006,9006,9006,9006,9006,0,0,9016,9016,9016,9016,0,0,9026,9026,9026,9026,0,9027,9027,9027,9027,9027,9027,9027,9027,9027,9027,9027,9027,9027,9027,9027,0,0,0,0
0,9036,9036,9036,9036,9036,9036,0,0,0,0,0,0,0,0,9005,9005,9005,9005,9005,0,9004,9004,9004,9004,9004,0,9006,9006,9006,9006,9006,0,0,0,9016,9016,9016,0,0,9026,9026,9026,9026,0,9027,9027,9027,9027,9027,9027,9027,9027,9027,9027,9027,9027,9027,9027,9027,0,0,0,0
0,9036,9036,9036,9036,9036,9036,0,0,0,0,0,0,0,0,9005,9005,9005,9005,9005,0,9004,9004,9004,9004,9004,0,9006,9006,9006,9006,9006,0,0,9016,0,9016,9016,0,0,9026,9026,9026,9026,0,9027,9027,9027,9027,9027,9027,9027,9027,9027,9027,9027,9027,9027,9027,9027,0,0,0,0
0,9036,9036,9036,9036,9036,9036,0,0,0,0,0,0,0,0,9005,9005,9005,9005,9005,0,9004,9004,9004,9004,9004,0,9006,9006,9006,9006,9006,0,0,9016,9016,9016,9016,0,0,9026,9026,9026,9026,0,0,0,0,0,0,0,0,0,0,0,0,0,0,0,0,0,0,0,0
0,9036,9036,9036,9036,9036,9036,0,0,0,0,0,0,0,0,9005,9005,9005,9005,9005,0,9004,9004,9004,9004,9004,0,9006,9006,9006,9006,9006,0,0,9016,9016,9016,9016,0,0,9026,9026,9026,9026,0,9025,9025,9025,9025,9025,9025,9025,9025,9025,9025,9025,9025,9025,9025,9025,0,0,0,0
0,9036,9036,9036,9036,9036,9036,0,0,0,0,0,0,0,0,9005,9005,9005,9005,9005,0,9004,9004,9004,9004,9004,0,9006,9006,9006,9006,9006,0,0,9016,9016,9016,9016,0,0,9026,9026,9026,9026,0,9025,9025,9025,9025,9025,9025,9025,9025,9025,9025,9025,9025,9025,9025,9025,0,0,0,0
0,9036,9036,9036,9036,9036,9036,0,0,0,0,0,0,0,0,9005,9005,9005,9005,9005,0,9004,9004,9004,9004,9004,0,9006,9006,9006,9006,9006,0,0,9016,9016,9016,9016,0,0,9026,9026,9026,9026,0,9025,9025,9025,9025,9025,9025,9025,9025,9025,9025,9025,9025,9025,9025,9025,0,0,0,0
0,9036,9036,9036,9036,9036,9036,0,0,0,0,0,0,0,0,9005,9005,9005,9005,9005,0,9004,9004,9004,9004,9004,0,9006,9006,9006,9006,9006,0,0,9016,9016,9016,9016,0,0,9026,9026,9026,9026,0,9025,9025,9025,9025,9025,9025,9025,9025,9025,9025,9025,9025,9025,9025,9025,0,0,0,0
0,9036,9036,9036,9036,9036,9036,0,0,0,0,0,0,0,0,9005,9005,9005,9005,9005,0,9004,9004,9004,9004,9004,0,9006,9006,9006,9006,9006,0,0,9016,9016,9016,9016,0,0,0,0,0,0,0,0,0,0,9011,0,0,0,0,0,0,0,0,0,0,0,0,0,0,0
0,9036,9036,9036,9036,9036,9036,0,0,0,0,0,0,0,0,0,0,0,0,0,0,9004,9004,9004,9004,9004,0,0,0,0,0,0,0,0,9016,9016,9016,9016,0,0,9024,9024,9024,9024,9024,9024,9024,9024,9024,9024,9024,9024,9024,9024,9024,0,9020,9020,9020,9020,0,0,0,0
0,9036,9036,9036,9036,9036,9036,0,0,0,0,0,9004,9004,9004,9004,9004,9004,9004,9004,9004,9004,9004,9004,9004,9004,9004,9004,9004,9004,9004,9004,0,9016,9016,9016,9016,9016,0,0,9024,9024,9024,9024,9024,9024,9024,9024,9024,9024,9024,9024,9024,9024,9024,0,9020,9020,9020,9020,0,0,0,0
0,9036,9036,9036,9036,9036,9036,0,0,9003,9003,0,9004,9004,9004,9004,9004,9004,9004,9004,9004,9004,9004,9004,9004,9004,9004,9004,9004,9004,9004,9004,0,9016,9016,9016,9016,9016,0,0,9024,9024,9024,9024,9024,9024,9024,9024,9024,9024,9024,9024,9024,9024,9024,0,9020,9020,9020,9020,0,0,0,0
0,0,0,0,0,0,0,0,0,9003,9003,0,9004,9004,9004,9004,9004,9004,9004,9004,9004,9004,9004,9004,9004,9004,9004,9004,9004,9004,9004,9004,0,9016,9016,9016,9016,9016,0,0,9024,9024,9024,9024,9024,9024,9024,9024,9024,9024,9024,9024,9024,9024,9024,0,0,0,0,0,0,0,0,0
0,9038,9038,9038,9038,9038,9038,0,0,9003,9003,0,9004,9004,9004,9004,9004,9004,9004,9004,9004,9004,9004,9004,9004,9004,9004,9004,9004,9004,9004,9004,0,9016,9016,9016,9016,9016,0,0,0,0,0,0,0,0,0,0,0,0,0,0,0,0,0,0,9019,9019,9019,9019,0,0,0,0
0,9038,9038,9038,9038,9038,9038,0,0,9003,9003,0,9004,9004,9004,9004,9004,9004,9004,9004,9004,9004,9004,9004,9004,9004,9004,9004,9004,9004,9004,9004,0,9016,9016,9016,9016,9016,0,0,9023,9023,9023,9023,9023,9023,9023,9023,9023,9023,9023,9023,9023,9023,9023,0,9019,9019,9019,9019,0,0,0,0
0,9038,0,0,0,9038,9038,0,0,9003,9003,0,0,0,0,0,0,0,0,0,0,0,9004,9004,9004,9004,9004,0,0,0,0,0,0,0,9016,9016,9016,9016,0,0,9023,9023,9023,9023,9023,9023,9023,9023,9023,9023,9023,9023,9023,9023,9023,0,9019,9019,9019,9019,0,0,0,0
0,9038,0,0,0,9038,9038,0,0,9003,9003,0,0,0,0,0,0,0,0,0,0,0,0,0,0,0,0,0,0,0,0,0,0,0,9016,9016,9016,9016,0,0,9023,9023,9023,9023,9023,9023,9023,9023,9023,9023,9023,9023,9023,9023,9023,0,9019,9019,9019,9019,0,0,0,0
0,0,0,0,0,0,0,0,0,9003,9003,9003,9003,9003,9003,0,0,9015,9015,9015,9015,0,9008,9008,9008,9008,9008,0,9012,9012,9012,9012,0,0,9016,9016,9016,9016,0,0,0,0,0,0,0,0,0,0,0,0,0,0,0,0,0,0,0,0,0,0,0,0,0,0
0,0,0,0,0,0,0,0,0,9003,9003,9003,9003,9003,9003,0,0,9015,9015,9015,9015,0,9008,9008,9008,9008,9008,0,9012,9012,9012,9012,0,0,9016,9016,9016,9016,0,0,9021,9021,9021,9021,0,9018,9018,9018,9018,9018,9018,9018,9018,9018,9018,9018,9018,9018,9018,9018,0,0,0,0
0,0,0,0,0,0,0,0,0,0,0,0,9003,9003,9003,0,0,9015,9015,9015,9015,0,9008,9008,9008,9008,9008,0,9012,9012,9012,9012,0,0,9016,9016,9016,9016,0,0,9021,9021,9021,9021,0,9018,9018,9018,9018,9018,9018,9018,9018,9018,9018,9018,9018,9018,9018,9018,0,0,0,0
0,0,0,0,0,0,0,0,0,0,0,0,0,0,0,0,0,9015,9015,9015,9015,0,9008,9008,9008,9008,9008,0,9012,9012,9012,9012,0,0,9016,9016,9016,9016,0,0,9021,9021,9021,9021,0,9018,9018,9018,9018,9018,9018,9018,9018,9018,9018,9018,9018,9018,9018,9018,0,0,0,0
0,9002,9002,0,9002,9002,9002,0,9002,9002,9002,0,9001,9001,9001,0,0,0,0,0,0,0,9008,9008,9008,9008,9008,0,0,0,0,0,0,0,9016,9016,9016,9016,0,0,9021,9021,9021,9021,0,9018,9018,9018,9018,9018,9018,9018,9018,9018,9018,9018,9018,9018,9018,9018,0,0,0,0
0,9002,9002,0,9002,9002,9002,0,9002,9002,9002,0,9001,9001,9001,0,0,9014,9014,9014,9014,0,9008,9008,9008,9008,9008,0,9011,9011,9011,9011,0,0,9016,9016,9016,9016,0,0,0,0,0,0,0,0,0,0,0,0,0,0,0,0,0,0,0,0,0,0,0,0,0,0
0,9002,9002,0,9002,9002,9002,0,9002,9002,9002,0,9001,9001,9001,0,0,9014,9014,9014,9014,0,9008,9008,9008,9008,9008,0,9011,9011,9011,9011,0,0,9016,9016,9016,9016,0,0,9022,9022,9022,9022,0,9017,9017,9017,9017,9017,9017,9017,9017,9017,9017,9017,9017,9017,9017,9017,0,0,0,0
0,9002,9002,0,0,0,0,0,0,0,0,0,9001,9001,9001,0,0,9014,9014,9014,9014,0,9008,9008,9008,9008,9008,0,9011,9011,9011,9011,0,0,9016,9016,9016,9016,0,0,9022,9022,9022,9022,0,9017,9017,9017,9017,9017,9017,9017,9017,9017,9017,9017,9017,9017,9017,9017,0,0,0,0
0,9002,9002,9002,9002,9002,9002,9002,9002,9002,9002,0,9001,9001,9001,0,0,9014,9014,9014,9014,0,9008,9008,9008,9008,9008,0,9011,9011,9011,9011,0,0,9016,9016,9016,9016,0,0,9022,9022,9022,9022,0,9017,9017,9017,9017,9017,9017,9017,9017,9017,9017,9017,9017,9017,9017,9017,0,0,0,0
0,9002,9002,9002,9002,9002,9002,9002,9002,9002,9002,0,9001,9001,9001,0,0,0,0,0,0,0,9008,9008,9008,9008,9008,0,0,0,0,0,0,0,9016,9016,9016,9016,0,0,0,0,0,0,0,0,0,0,0,0,0,0,0,0,0,0,0,0,0,0,0,0,0,0
0,9002,9002,9002,9002,9002,9002,9002,9002,9002,9002,0,9001,9001,9001,0,0,9013,9013,9013,9013,0,9008,9008,9008,9008,9008,0,9010,9010,9010,9010,0,0,9016,9016,9016,9016,0,0,0,0,0,0,0,0,0,0,0,0,9016,9016,9016,9016,9016,9016,0,0,0,0,0,0,0,0
0,9002,9002,0,0,0,0,0,0,0,0,0,9001,9001,9001,0,0,9013,9013,9013,9013,0,0,0,0,0,0,0,9010,9010,9010,9010,0,0,9016,9016,9016,9016,9016,9016,9016,9016,9016,9016,9016,9016,9016,9016,9016,9016,9016,9016,9016,9016,9016,9016,9016,9016,9016,9016,0,0,0,0
0,9002,9002,0,9002,9002,9002,0,9002,9002,9002,0,9001,9001,9001,0,0,9013,9013,9013,9013,0,9009,9009,9009,9009,9009,0,9010,9010,9010,9010,0,0,9016,9016,9016,9016,9016,9016,9016,9016,9016,9016,9016,9016,9016,9016,9016,9016,9016,9016,9016,9016,9016,9016,9016,9016,9016,9016,0,0,0,0
0,9002,9002,0,9002,9002,9002,0,9002,9002,9002,0,9001,9001,9001,0,0,9013,9013,9013,9013,0,9009,9009,9009,9009,9009,0,9010,9010,9010,9010,0,0,9016,9016,9016,9016,9016,9016,9016,9016,9016,9016,9016,9016,9016,9016,9016,9016,9016,9016,9016,9016,9016,9016,9016,9016,9016,9016,0,0,0,0
0,9002,9002,0,9002,9002,9002,0,9002,9002,9002,0,9001,9001,9001,0,0,9013,9013,9013,9013,0,9009,9009,9009,9009,9009,0,9010,9010,9010,9010,0,0,9016,9016,9016,9016,9016,9016,9016,9016,9016,9016,9016,9016,9016,9016,9016,9016,9016,9016,9016,9016,9016,9016,9016,9016,9016,9016,0,0,0,0
0,0,0,0,0,0,0,0,0,0,0,0,0,0,0,0,0,0,0,0,0,0,0,0,0,0,0,0,0,0,0,0,0,0,0,0,0,0,0,0,0,0,0,0,0,0,0,0,0,0,0,0,0,0,0,0,0,0,0,0,0,0,0,0
0,0,0,0,0,0,0,0,0,0,0,0,0,0,0,0,0,0,0,0,0,0,0,0,0,0,0,0,0,0,0,0,0,0,0,0,0,0,0,0,0,0,0,0,0,0,0,0,0,0,0,0,0,0,0,0,0,0,0,0,0,0,0,0
