64
1035
1043
0,0,0,0,0,0,0,0,0,0,0,0,0,0,0,0,0,0,0,0,0,0,0,0,0,0,0,0,0,0,0,0,0,0,0,0,0,0,0,0,0,0,0,0,0,0,0,0,0,0,0,0,0,0,0,0,0,0,0,0,0,0,0,0
0,0,0,0,0,0,0,0,0,0,0,0,0,0,0,0,0,0,0,0,0,0,0,0,0,0,0,0,0,0,0,0,0,0,0,0,0,0,0,0,0,0,0,0,0,0,0,0,0,0,0,0,0,0,0,0,0,0,0,0,0,0,0,0
0,0,0,0,0,0,0,0,0,0,0,0,0,0,0,0,0,0,0,0,0,0,0,0,0,0,0,0,0,0,0,0,0,0,0,0,0,0,0,0,0,0,0,0,1030,1030,1030,1030,1030,1030,1030,1030,1030,1030,1030,1030,1030,1030,0,0,0,0,0,0
0,0,0,0,0,0,0,0,0,0,0,0,0,0,0,0,0,0,0,0,0,0,0,0,0,0,0,0,0,0,0,0,0,0,0,0,0,0,0,0,0,0,0,0,1030,4002,4007,4002,1030,0,0,0,0,0,0,0,0,1030,0,0,0,0,0,0
0,0,0,0,0,0,0,0,0,0,0,0,0,0,0,0,0,0,1030,1030,1030,1030,1030,1030,1030,1030,1030,1030,1030,1030,1030,1030,1030,1030,1030,1030,1030,1030,1030,1030,1030,1030,1030,1030,1030,0,0,0,1030,0,0,0,2028,0,0,0,0,1030,1030,0,0,0,0,0
0,0,0,0,0,0,0,0,0,0,0,0,0,0,0,0,0,0,1030,0,0,0,0,0,0,0,0,0,0,0,0,0,0,0,0,0,0,0,0,0,0,0,0,0,0,0,0,0,3005,0,0,0,0,0,0,0,4011,1030,1030,0,0,0,0,0
0,0,0,0,0,0,0,0,0,0,0,0,0,0,0,0,0,0,1030,0,0,0,0,0,0,0,0,0,0,0,0,0,0,0,0,0,0,0,0,0,0,0,0,0,0,0,0,2044,1030,0,0,0,2028,0,0,0,0,1030,1030,0,0,0,0,0
0,0,0,0,0,0,0,0,0,0,0,0,0,0,0,0,0,0,1030,0,0,1030,1030,1030,1030,1030,1030,1030,1030,1030,1030,1030,1030,3002,1030,1030,1030,1030,1030,1030,1030,1030,1030,1030,1030,1030,1030,1030,1030,0,0,0,0,0,0,0,0,1030,1030,0,0,0,0,0
0,0,0,0,0,0,0,0,0,0,0,0,0,0,0,0,0,0,1030,0,0,1030,0,0,0,0,0,0,0,0,0,1030,0,0,0,1030,0,0,0,0,0,0,0,0,0,0,0,0,1030,0,0,0,0,0,0,0,0,1030,0,0,0,0,0,0
0,0,0,0,0,0,0,0,0,0,0,0,0,0,0,0,0,0,1030,0,0,1030,0,0,0,0,0,0,0,0,0,1030,0,0,0,1030,0,0,0,0,0,0,0,0,0,0,0,0,1030,0,0,0,0,0,0,0,0,1030,0,0,0,0,0,0
0,0,0,0,0,0,0,0,0,0,0,0,0,0,0,0,0,0,1030,0,0,1030,0,0,0,0,0,0,0,0,0,1030,0,0,0,1030,0,0,0,0,0,0,0,0,0,0,0,0,1030,1030,1030,1030,1030,1030,1030,1030,1030,1030,0,0,0,0,0,0
0,0,0,0,0,0,0,0,0,0,0,0,0,0,0,0,0,0,1030,0,0,1030,0,0,0,0,0,0,0,0,0,1030,0,0,0,1030,0,0,0,0,0,0,0,0,0,0,0,0,0,0,0,0,0,0,0,0,0,0,0,0,0,0,0,0
0,0,0,0,0,0,0,0,0,0,0,0,0,0,0,0,0,0,1030,0,0,1030,0,0,0,0,0,0,0,0,0,1030,0,0,0,1030,0,0,0,0,0,0,1030,1030,1030,1030,1030,1030,1030,1030,1030,1030,1030,1030,1030,1030,1030,0,0,0,0,0,0,0
0,0,0,0,0,0,0,0,0,0,0,0,0,0,0,0,0,0,1030,0,0,1030,0,0,0,0,0,0,0,0,0,1030,0,0,0,1030,0,0,0,0,0,0,1030,0,0,0,0,0,0,0,0,0,0,0,0,0,1030,0,0,0,0,0,0,0
0,0,0,0,0,0,0,0,0,0,0,0,0,0,0,0,0,0,1030,0,0,1030,0,0,0,0,0,0,0,0,0,1030,0,0,0,1030,1030,1030,1030,1030,1030,1030,1030,0,0,0,0,0,0,0,0,0,0,0,0,0,1030,0,0,0,0,0,0,0
0,0,0,0,0,0,0,0,0,0,0,0,0,0,0,0,0,0,1030,0,0,1030,0,0,0,0,0,0,0,0,0,1030,0,0,0,0,0,0,0,0,4002,4007,1030,0,0,0,0,0,0,0,0,0,0,0,0,0,1030,0,0,0,0,0,0,0
0,0,0,0,0,0,0,0,0,0,0,0,0,0,0,0,0,0,1030,0,0,1030,0,0,0,0,0,0,0,0,0,1030,0,0,0,0,0,0,0,0,0,0,3001,0,0,0,2044,0,0,0,0,0,0,0,4009,0,1030,0,0,0,0,0,0,0
0,0,0,0,0,0,0,0,0,0,0,0,0,0,0,0,0,0,1030,0,0,1030,0,0,0,0,0,0,0,0,0,1030,1030,1030,1030,1030,1030,1030,1030,1030,1030,1030,1030,0,0,0,0,0,0,0,0,0,0,0,0,0,1030,0,0,0,0,0,0,0
0,0,0,0,0,0,0,0,0,0,0,0,0,0,0,0,0,0,1030,0,0,1030,0,0,0,0,0,0,0,0,0,0,0,0,0,0,0,0,0,0,0,0,1030,0,0,0,0,0,0,0,0,0,0,0,0,0,1030,0,0,0,0,0,0,0
0,0,0,0,0,0,0,0,0,0,0,0,0,0,0,0,0,1030,1030,0,0,1030,1030,0,0,0,0,0,0,0,0,0,0,0,0,0,0,0,0,0,0,0,1030,1030,1030,1030,1030,1030,1030,1030,1030,1030,1030,1030,1030,1030,1030,0,0,0,0,0,0,0
0,0,1018,1018,1018,1018,1018,1018,1018,1018,1018,1018,1018,1018,1018,1018,1018,1018,0,0,0,0,1021,1021,1021,1021,1021,1021,1021,1021,1021,1021,0,0,0,0,0,0,0,0,0,0,0,0,1021,1021,1021,1021,1021,1021,1021,1021,1021,1021,1021,1021,1021,1021,1021,1021,1021,1021,0,0
0,0,1018,2002,0,0,1018,0,0,0,0,0,0,1018,0,2026,0,3003,0,0,0,0,3001,0,0,0,0,0,0,0,0,1021,0,0,0,0,0,0,0,0,0,0,0,0,1021,4002,0,0,0,0,0,0,0,0,0,0,0,0,0,0,4002,1021,0,0
0,0,1018,0,0,0,3001,0,0,0,0,0,2004,1018,0,0,0,1018,0,0,0,0,1021,0,0,0,0,0,0,0,0,1021,1021,1021,1021,1021,1021,1021,1021,1021,1021,1021,1021,1021,1021,0,2036,0,0,0,0,0,0,0,0,0,0,0,2034,0,0,1021,0,0
0,0,1018,0,0,0,1018,1018,3002,1018,1018,1018,1018,1018,1018,3002,1001,1018,1030,0,0,1030,1021,0,0,0,0,0,0,0,0,1021,0,0,0,0,0,0,0,0,0,0,0,4007,1021,0,0,0,0,0,0,0,0,0,0,0,0,0,0,0,4007,1021,0,0
0,0,1018,0,0,0,1018,0,0,0,1018,0,2002,1018,4007,0,4002,1018,1030,0,0,1030,1021,0,0,0,2027,0,0,0,0,3001,0,0,0,0,0,2019,0,0,0,0,0,0,3001,0,2046,0,0,0,0,0,0,0,0,0,0,0,2045,0,0,1021,0,0
0,0,1018,0,0,0,1018,0,2001,0,1018,0,0,3001,0,0,0,1018,1030,0,0,1030,1021,0,0,0,0,0,0,0,0,1021,0,0,0,0,0,0,0,0,0,0,0,4001,1021,0,2033,0,0,0,0,0,0,0,0,0,0,0,2035,0,0,1021,0,0
0,0,1018,3002,1018,1018,1018,1018,3002,1018,1018,1018,0,1018,0,0,0,1018,1030,4002,4007,1030,1021,0,0,0,0,0,0,0,0,1021,1021,1021,1021,1021,1021,1021,1021,1021,1021,1021,1021,1021,1021,4002,0,0,0,0,0,0,0,4007,0,0,0,0,0,0,4002,1021,0,0
0,0,1018,2002,0,1018,0,0,0,0,0,1018,3002,1018,1018,1018,3002,1018,1030,1030,1030,1030,1021,0,0,0,0,0,0,0,0,1021,0,0,0,0,0,0,0,0,0,0,0,0,1021,1021,1021,1021,1021,1021,1021,3002,1021,1021,1021,1021,1021,1021,1021,1021,1021,1021,0,0
0,0,1018,0,0,1018,4002,0,0,0,0,1018,0,0,1018,4007,0,4003,1018,0,0,1021,1021,0,0,0,0,0,0,0,0,1021,0,0,0,0,0,0,0,0,0,0,0,0,0,0,0,0,0,1024,4002,0,0,4007,1024,0,0,0,0,0,0,0,0,0
0,0,1018,3002,1018,1018,1018,1018,1018,1018,0,3001,0,0,1018,0,0,0,1018,0,0,1021,1021,0,0,0,0,0,0,0,0,1021,0,0,0,0,0,0,0,0,0,0,0,0,0,0,0,0,0,1024,2036,2036,2036,2036,1024,0,0,0,0,0,0,0,0,0
0,0,1018,0,0,0,0,0,0,1018,2001,1018,0,0,1018,0,2041,0,1018,0,0,1021,1021,4007,4003,0,0,0,0,0,2001,1021,0,0,0,0,0,0,0,0,0,0,0,0,0,0,0,0,0,1024,2014,2014,2014,2014,1024,0,0,0,0,0,0,0,0,0
0,0,1018,1018,1018,1018,1018,3002,1018,1018,1001,1018,1018,1018,1018,1018,1018,1018,1018,0,0,1021,1021,1021,1021,1021,1021,1021,1021,1021,1021,1021,0,0,0,0,0,0,0,0,0,0,0,0,0,0,0,0,0,1024,0,0,0,0,1024,0,0,0,0,0,0,0,0,0
0,0,0,0,0,1019,0,0,0,1019,0,0,0,0,0,0,0,0,0,0,0,0,0,0,0,0,0,0,0,0,0,0,0,0,0,0,0,0,0,0,0,0,0,0,0,0,0,0,0,1024,0,0,0,0,1024,0,0,0,0,0,0,0,0,0
0,0,0,0,0,1019,2036,2036,2036,1019,0,0,0,0,0,1019,1019,1019,1019,1019,1019,1019,1019,1019,1019,0,0,0,0,0,0,0,0,0,0,0,0,0,0,0,0,0,0,0,0,0,0,0,0,1024,0,0,0,0,1024,0,0,0,0,0,0,0,0,0
0,0,0,0,0,1019,2010,2010,2010,1019,0,0,0,0,0,1019,0,0,0,0,0,0,0,0,1019,0,0,0,0,0,0,0,0,0,0,0,0,0,0,0,0,0,0,0,0,0,0,0,0,1024,0,0,0,0,1024,0,0,0,0,0,0,0,0,0
0,0,0,0,0,1019,0,0,0,1019,0,0,0,0,0,1019,0,0,2026,4008,0,0,0,0,1019,0,0,0,0,0,0,0,0,0,0,0,0,0,0,0,0,0,0,0,0,0,0,0,0,1024,0,0,0,0,1024,0,0,0,0,0,0,0,0,0
0,0,0,0,0,1019,0,0,0,1019,0,0,0,0,0,1019,0,0,0,0,0,0,0,0,1019,0,0,0,0,0,0,0,0,0,0,0,0,0,0,0,0,0,0,0,0,0,0,0,0,1024,0,0,0,0,1024,0,0,0,0,0,0,0,0,0
0,0,0,0,0,1019,0,0,0,1019,0,0,0,0,0,1019,0,0,0,0,0,0,0,0,1019,0,0,0,0,0,0,0,0,0,0,0,0,0,0,0,0,0,0,0,0,0,0,0,0,1024,0,0,0,0,1024,0,0,0,0,0,0,0,0,0
0,0,0,0,0,1019,0,0,0,1019,0,0,0,0,0,1019,0,0,0,0,0,0,0,0,1019,0,0,0,0,0,0,0,0,0,0,0,0,0,0,0,0,0,0,0,0,0,0,0,0,1024,0,0,0,0,1024,0,0,0,0,0,0,0,0,0
0,0,0,0,0,1019,0,0,0,1019,0,0,0,0,0,1019,0,0,0,0,0,0,4007,4003,1019,0,0,0,0,0,0,0,0,0,0,0,0,0,0,0,0,0,0,0,0,0,0,0,0,1024,0,0,0,0,1024,0,0,0,0,0,0,0,0,0
0,0,0,0,0,1019,0,0,0,1019,0,0,0,0,0,1019,1019,1019,3002,1019,1019,1019,1019,1019,1019,1019,1019,1019,1019,1019,1019,1019,0,0,0,0,0,0,0,0,0,0,0,0,0,0,0,0,0,1024,0,0,0,0,1024,0,0,0,0,0,0,0,0,0
0,0,0,0,0,1019,0,0,0,1019,0,0,0,0,0,1019,0,2018,0,2018,0,0,0,0,0,0,0,0,0,0,0,1019,0,0,0,0,0,0,0,0,0,0,0,0,0,0,0,0,0,1024,0,0,0,0,1024,0,0,0,0,0,0,0,0,0
0,0,0,0,0,1019,0,0,0,1019,0,0,0,0,0,1019,0,0,0,0,0,0,0,0,0,0,0,0,0,0,0,1019,1024,1024,1024,1024,1024,1024,1024,1024,1024,1024,1024,0,0,0,0,0,0,1024,0,0,0,0,1024,0,0,0,0,0,0,0,0,0
0,0,0,0,0,1019,0,0,0,1019,0,0,0,0,0,1019,0,0,0,0,0,0,0,0,0,0,0,0,0,0,0,1019,1024,0,0,0,0,0,0,0,0,0,1024,0,0,0,0,0,0,1024,2035,2035,2035,2035,1024,0,0,0,0,0,0,0,0,0
0,0,0,0,0,1019,0,0,0,1019,0,0,0,0,0,1019,0,0,2033,0,0,0,0,2007,0,0,0,0,2034,0,0,1019,0,2036,0,0,0,2016,0,0,2034,0,1024,0,0,0,0,0,0,1024,0,0,0,0,1024,0,0,0,0,0,0,0,0,0
0,0,0,0,0,1019,0,0,0,1019,0,0,0,0,0,1019,0,0,0,0,0,0,0,0,0,0,0,0,0,0,0,3001,0,0,0,0,0,0,0,0,0,0,1024,0,0,0,0,0,0,1024,4007,0,0,4002,1024,0,0,0,0,0,0,0,0,0
0,0,0,0,0,1019,0,0,0,1019,0,0,0,0,0,1019,0,0,0,0,0,0,0,0,0,0,0,0,0,0,0,1019,0,0,0,0,0,0,0,0,0,0,1024,1024,1024,1024,1024,1024,1024,1024,1024,3002,1024,1024,1024,1024,1024,1024,1024,0,0,0,0,0
0,0,0,0,0,1019,0,0,0,1019,0,0,0,0,0,1019,4002,0,4007,0,0,0,0,0,0,0,0,0,0,0,0,1019,1024,0,0,0,0,0,0,0,0,0,1024,2036,0,0,0,0,0,2007,0,0,0,0,0,0,0,2034,1024,0,0,0,0,0
0,0,0,0,0,1019,0,0,0,1019,0,0,0,0,0,1019,1019,1019,1019,1019,1019,1019,1019,1019,1019,3002,1019,1019,1019,1019,1019,1019,1024,2014,0,0,0,0,0,0,2013,0,1024,0,0,0,0,0,0,0,0,0,0,0,0,0,0,0,1024,0,0,0,0,0
0,0,0,0,0,1019,0,0,0,1019,0,0,0,0,0,0,0,0,0,0,0,0,0,1019,2036,0,2034,1019,1024,1024,1024,1024,1024,0,0,0,0,0,0,0,0,0,1024,2033,0,0,2008,0,0,0,0,0,2036,0,0,0,0,0,1024,0,0,0,0,0
0,0,0,0,0,1019,2035,2035,2035,1019,0,0,0,0,0,0,0,0,0,0,0,0,0,1019,0,0,0,1019,1024,0,0,0,0,0,0,0,0,0,0,0,0,0,1024,1024,1024,1024,1024,1024,1024,1024,1024,1024,0,0,0,0,0,0,1024,0,0,0,0,0
0,0,0,0,0,1019,0,0,0,1019,0,0,0,0,0,0,0,0,0,0,0,0,0,1019,0,0,0,1019,1024,4002,0,0,0,0,0,0,0,0,0,0,0,0,1024,0,0,0,0,0,0,0,0,1024,0,0,0,0,0,0,1024,0,0,0,0,0
0,0,0,0,0,1019,4007,0,4001,1019,0,0,0,0,0,0,0,0,0,0,0,0,0,1019,0,0,0,1019,1024,4007,0,0,0,2033,0,0,0,2015,0,0,2035,0,1024,0,0,0,0,0,0,0,0,1024,0,0,0,0,0,0,1024,0,0,0,0,0
0,0,0,1019,1019,1019,1019,3002,1019,1019,1019,1019,1019,0,0,0,0,0,0,0,0,0,0,1019,0,0,0,1019,1024,4002,0,0,0,0,0,0,0,0,0,0,0,0,1024,0,0,0,0,0,0,0,0,1024,0,0,0,0,0,0,1024,0,0,0,0,0
0,0,0,1019,4007,0,0,0,0,0,0,4002,1019,0,0,0,0,0,0,0,0,0,0,1019,0,0,2013,1019,1024,1024,1024,1024,1024,1024,1024,1024,1024,1024,1024,1024,1024,1024,1024,0,0,0,0,0,0,0,0,1024,0,0,0,0,0,0,1024,0,0,0,0,0
0,0,0,1019,0,0,0,0,0,0,0,0,1019,1019,1019,1019,1019,1019,1019,1019,1019,1019,1019,1019,0,0,0,1019,0,0,0,0,0,0,0,0,0,0,0,0,0,0,0,0,0,0,0,0,0,0,0,1024,2006,0,0,0,0,2005,1024,0,0,0,0,0
0,0,0,1019,0,0,0,0,0,0,0,0,1019,2036,0,0,0,0,0,0,0,0,0,0,2034,0,0,1019,0,0,0,0,0,0,0,0,0,0,0,0,0,0,0,0,0,0,0,0,0,0,0,1024,0,0,0,0,0,0,1024,0,0,0,0,0
0,0,0,1019,0,0,0,0,0,0,0,0,3001,0,0,0,0,0,0,0,0,0,0,0,0,0,0,1019,0,0,0,0,0,0,0,0,0,0,0,0,0,0,0,0,1024,1024,1024,1024,1024,1024,1024,1024,0,0,0,0,0,0,1024,0,0,0,0,0
0,0,0,1019,0,0,0,0,0,0,0,0,1019,2033,0,0,0,0,2015,0,0,0,0,0,0,0,2035,1019,0,0,0,0,0,0,0,0,0,0,0,0,0,0,0,0,1024,2036,0,0,2007,0,0,0,2034,0,0,0,0,0,1024,0,0,0,0,0
0,0,0,1019,0,0,0,4010,0,0,0,0,1019,1019,1019,1019,1019,1019,1019,1019,1019,1019,1019,1019,1019,1019,1019,1019,0,0,0,0,0,0,0,0,0,0,0,0,0,0,0,0,1024,0,4003,4007,0,0,0,0,0,0,0,0,0,0,1024,0,0,0,0,0
0,0,0,1019,0,0,0,0,0,0,0,0,1019,0,0,0,0,0,0,0,0,0,0,0,0,0,0,0,0,0,0,0,0,0,0,0,0,0,0,0,0,0,0,0,1024,2033,0,0,0,0,0,2008,0,0,0,0,0,2035,1024,0,0,0,0,0
0,0,0,1019,1019,1019,1019,1019,1019,1019,1019,1019,1019,0,0,0,0,0,0,0,0,0,0,0,0,0,0,0,0,0,0,0,0,0,0,0,0,0,0,0,0,0,0,0,1024,1024,1024,1024,1024,1024,1024,1024,1024,1024,1024,1024,1024,1024,1024,0,0,0,0,0
0,0,0,0,0,0,0,0,0,0,0,0,0,0,0,0,0,0,0,0,0,0,0,0,0,0,0,0,0,0,0,0,0,0,0,0,0,0,0,0,0,0,0,0,0,0,0,0,0,0,0,0,0,0,0,0,0,0,0,0,0,0,0,0
0,0,0,0,0,0,0,0,0,0,0,0,0,0,0,0,0,0,0,0,0,0,0,0,0,0,0,0,0,0,0,0,0,0,0,0,0,0,0,0,0,0,0,0,0,0,0,0,0,0,0,0,0,0,0,0,0,0,0,0,0,0,0,0

0,0,0,0,0,0,0,0,0,0,0,0,0,0,0,0,0,0,0,0,0,0,0,0,0,0,0,0,0,0,0,0,0,0,0,0,0,0,0,0,0,0,0,0,0,0,0,0,0,0,0,0,0,0,0,0,0,0,0,0,0,0,0,0
0,0,0,0,0,0,0,0,0,0,0,0,0,0,0,0,0,0,0,0,0,0,0,0,0,0,0,0,0,0,0,0,0,0,0,0,0,0,0,0,0,0,0,0,0,0,0,0,0,0,0,0,0,0,0,0,0,0,0,0,0,0,0,0
0,0,0,0,0,0,0,0,0,0,0,0,0,0,0,0,0,0,0,0,0,0,0,0,0,0,0,0,0,0,0,0,0,0,0,0,0,0,0,0,0,0,0,0,0,0,0,0,0,0,0,0,0,0,0,0,0,0,0,0,0,0,0,0
0,0,0,0,0,0,0,0,0,0,0,0,0,0,0,0,0,0,0,0,0,0,0,0,0,0,0,0,0,0,0,0,0,0,0,0,0,0,0,0,0,0,0,0,0,9022,9022,9022,0,9023,9023,9023,9023,9023,9023,9023,9023,0,0,0,0,0,0,0
0,0,0,0,0,0,0,0,0,0,0,0,0,0,0,0,0,0,0,0,0,0,0,0,0,0,0,0,0,0,0,0,0,0,0,0,0,0,0,0,0,0,0,0,0,9022,9022,9022,0,9023,9023,9023,9023,9023,9023,9023,9023,0,0,0,0,0,0,0
0,0,0,0,0,0,0,0,0,0,0,0,0,0,0,0,0,0,0,9022,9022,9022,9022,9022,9022,9022,9022,9022,9022,9022,9022,9022,9022,9022,9022,9022,9022,9022,9022,9022,9022,9022,9022,9022,9022,9022,9022,9022,0,9023,9023,9023,9023,9023,9023,9023,9023,0,0,0,0,0,0,0
0,0,0,0,0,0,0,0,0,0,0,0,0,0,0,0,0,0,0,9022,9022,9022,9022,9022,9022,9022,9022,9022,9022,9022,9022,9022,9022,9022,9022,9022,9022,9022,9022,9022,9022,9022,9022,9022,9022,9022,9022,9022,0,9023,9023,9023,9023,9023,9023,9023,9023,0,0,0,0,0,0,0
0,0,0,0,0,0,0,0,0,0,0,0,0,0,0,0,0,0,0,9022,9022,0,0,0,0,0,0,0,0,0,0,0,0,0,0,0,0,0,0,0,0,0,0,0,0,0,0,0,0,9023,9023,9023,9023,9023,9023,9023,9023,0,0,0,0,0,0,0
0,0,0,0,0,0,0,0,0,0,0,0,0,0,0,0,0,0,0,9022,9022,0,0,0,0,0,0,0,0,0,0,0,9024,9024,9024,0,0,0,0,0,0,0,0,0,0,0,0,0,0,9023,9023,9023,9023,9023,9023,9023,9023,0,0,0,0,0,0,0
0,0,0,0,0,0,0,0,0,0,0,0,0,0,0,0,0,0,0,9022,9022,0,0,0,0,0,0,0,0,0,0,0,9024,9024,9024,0,0,0,0,0,0,0,0,0,0,0,0,0,0,9023,9023,9023,9023,9023,9023,9023,9023,0,0,0,0,0,0,0
0,0,0,0,0,0,0,0,0,0,0,0,0,0,0,0,0,0,0,9022,9022,0,0,0,0,0,0,0,0,0,0,0,9024,9024,9024,0,0,0,0,0,0,0,0,0,0,0,0,0,0,0,0,0,0,0,0,0,0,0,0,0,0,0,0,0
0,0,0,0,0,0,0,0,0,0,0,0,0,0,0,0,0,0,0,9022,9022,0,0,0,0,0,0,0,0,0,0,0,9024,9024,9024,0,0,0,0,0,0,0,0,0,0,0,0,0,0,0,0,0,0,0,0,0,0,0,0,0,0,0,0,0
0,0,0,0,0,0,0,0,0,0,0,0,0,0,0,0,0,0,0,9022,9022,0,0,0,0,0,0,0,0,0,0,0,9024,9024,9024,0,0,0,0,0,0,0,0,0,0,0,0,0,0,0,0,0,0,0,0,0,0,0,0,0,0,0,0,0
0,0,0,0,0,0,0,0,0,0,0,0,0,0,0,0,0,0,0,9022,9022,0,0,0,0,0,0,0,0,0,0,0,9024,9024,9024,0,0,0,0,0,0,0,0,9025,9025,9025,9025,9025,9025,9025,9025,9025,9025,9025,9025,9025,0,0,0,0,0,0,0,0
0,0,0,0,0,0,0,0,0,0,0,0,0,0,0,0,0,0,0,9022,9022,0,0,0,0,0,0,0,0,0,0,0,9024,9024,9024,0,0,0,0,0,0,0,0,9025,9025,9025,9025,9025,9025,9025,9025,9025,9025,9025,9025,9025,0,0,0,0,0,0,0,0
0,0,0,0,0,0,0,0,0,0,0,0,0,0,0,0,0,0,0,9022,9022,0,0,0,0,0,0,0,0,0,0,0,9024,9024,9024,9024,9024,9024,9024,9024,9024,9024,0,9025,9025,9025,9025,9025,9025,9025,9025,9025,9025,9025,9025,9025,0,0,0,0,0,0,0,0
0,0,0,0,0,0,0,0,0,0,0,0,0,0,0,0,0,0,0,9022,9022,0,0,0,0,0,0,0,0,0,0,0,9024,9024,9024,9024,9024,9024,9024,9024,9024,9024,0,9025,9025,9025,9025,9025,9025,9025,9025,9025,9025,9025,9025,9025,0,0,0,0,0,0,0,0
0,0,0,0,0,0,0,0,0,0,0,0,0,0,0,0,0,0,0,9022,9022,0,0,0,0,0,0,0,0,0,0,0,0,0,0,0,0,0,0,0,0,0,0,9025,9025,9025,9025,9025,9025,9025,9025,9025,9025,9025,9025,9025,0,0,0,0,0,0,0,0
0,0,0,0,0,0,0,0,0,0,0,0,0,0,0,0,0,0,0,9022,9022,0,0,0,0,0,0,0,0,0,0,0,0,0,0,0,0,0,0,0,0,0,0,9025,9025,9025,9025,9025,9025,9025,9025,9025,9025,9025,9025,9025,0,0,0,0,0,0,0,0
0,0,0,0,0,0,0,0,0,0,0,0,0,0,0,0,0,0,0,9022,9022,0,0,0,0,0,0,0,0,0,0,0,0,0,0,0,0,0,0,0,0,0,0,0,0,0,0,0,0,0,0,0,0,0,0,0,0,0,0,0,0,0,0,0
0,0,0,0,0,0,0,0,0,0,0,0,0,0,0,0,0,0,9022,9022,9022,9022,0,0,0,0,0,0,0,0,0,0,0,0,0,0,0,0,0,0,0,0,0,0,0,0,0,0,0,0,0,0,0,0,0,0,0,0,0,0,0,0,0,0
0,0,0,9014,9014,9014,0,9015,9015,9015,9015,9015,9015,0,9021,9021,9021,0,9022,9022,9022,9022,0,9010,9010,9010,9010,9010,9010,9010,9010,0,0,0,0,0,0,0,0,0,0,0,0,0,0,9008,9008,9008,9008,9008,9008,9008,9008,9008,9008,9008,9008,9008,9008,9008,9008,0,0,0
0,0,0,9014,9014,9014,0,9015,9015,9015,9015,9015,9015,0,9021,9021,9021,0,9022,9022,9022,9022,0,9010,9010,9010,9010,9010,9010,9010,9010,0,0,0,0,0,0,0,0,0,0,0,0,0,0,9008,9008,9008,9008,9008,9008,9008,9008,9008,9008,9008,9008,9008,9008,9008,9008,0,0,0
0,0,0,9014,9014,9014,0,0,0,0,0,0,0,0,0,0,0,0,0,9022,9022,0,0,9010,9010,9010,9010,9010,9010,9010,9010,0,9009,9009,9009,9009,9009,9009,9009,9009,9009,9009,9009,9009,0,9008,9008,9008,9008,9008,9008,9008,9008,9008,9008,9008,9008,9008,9008,9008,9008,0,0,0
0,0,0,9014,9014,9014,0,9016,9016,9016,0,9018,9018,0,9019,9019,9019,0,0,9022,9022,0,0,9010,9010,9010,9010,9010,9010,9010,9010,0,9009,9009,9009,9009,9009,9009,9009,9009,9009,9009,9009,9009,0,9008,9008,9008,9008,9008,9008,9008,9008,9008,9008,9008,9008,9008,9008,9008,9008,0,0,0
0,0,0,9014,9014,9014,0,9016,9016,9016,0,9018,9018,0,9019,9019,9019,0,0,9022,9022,0,0,9010,9010,9010,9010,9010,9010,9010,9010,0,9009,9009,9009,9009,9009,9009,9009,9009,9009,9009,9009,9009,0,9008,9008,9008,9008,9008,9008,9008,9008,9008,9008,9008,9008,9008,9008,9008,9008,0,0,0
0,0,0,0,0,0,0,0,0,0,0,0,9018,0,9019,9019,9019,0,0,9022,9022,0,0,9010,9010,9010,9010,9010,9010,9010,9010,0,0,0,0,0,0,0,0,0,0,0,0,0,0,9008,9008,9008,9008,9008,9008,9008,9008,9008,9008,9008,9008,9008,9008,9008,9008,0,0,0
0,0,0,9013,9013,0,9017,9017,9017,9017,9017,0,9018,0,0,0,0,0,0,0,0,0,0,9010,9010,9010,9010,9010,9010,9010,9010,0,0,0,0,0,0,0,0,0,0,0,0,0,0,0,0,0,0,0,0,0,0,0,0,0,0,0,0,0,0,0,0,0
0,0,0,9013,9013,0,9017,9017,9017,9017,9017,0,9018,9018,0,9020,9020,9020,0,0,0,0,0,9010,9010,9010,9010,9010,9010,9010,9010,0,0,0,0,0,0,0,0,0,0,0,0,0,0,0,0,0,0,0,9007,9007,9007,9007,0,0,0,0,0,0,0,0,0,0
0,0,0,0,0,0,0,0,0,0,9017,0,9018,9018,0,9020,9020,9020,0,0,0,0,0,9010,9010,9010,9010,9010,9010,9010,9010,0,0,0,0,0,0,0,0,0,0,0,0,0,0,0,0,0,0,0,9007,9007,9007,9007,0,0,0,0,0,0,0,0,0,0
0,0,0,9012,9012,9012,9012,9012,9012,0,9017,0,9018,9018,0,9020,9020,9020,0,0,0,0,0,9010,9010,9010,9010,9010,9010,9010,9010,0,0,0,0,0,0,0,0,0,0,0,0,0,0,0,0,0,0,0,9007,9007,9007,9007,0,0,0,0,0,0,0,0,0,0
0,0,0,0,0,0,0,0,0,0,0,0,0,0,0,0,0,0,0,0,0,0,0,0,0,0,0,0,0,0,0,0,0,0,0,0,0,0,0,0,0,0,0,0,0,0,0,0,0,0,9007,9007,9007,9007,0,0,0,0,0,0,0,0,0,0
0,0,0,0,0,0,9011,9011,9011,0,0,0,0,0,0,0,0,0,0,0,0,0,0,0,0,0,0,0,0,0,0,0,0,0,0,0,0,0,0,0,0,0,0,0,0,0,0,0,0,0,9007,9007,9007,9007,0,0,0,0,0,0,0,0,0,0
0,0,0,0,0,0,9011,9011,9011,0,0,0,0,0,0,0,0,0,0,0,0,0,0,0,0,0,0,0,0,0,0,0,0,0,0,0,0,0,0,0,0,0,0,0,0,0,0,0,0,0,9007,9007,9007,9007,0,0,0,0,0,0,0,0,0,0
0,0,0,0,0,0,9011,9011,9011,0,0,0,0,0,0,0,9004,9004,9004,9004,9004,9004,9004,9004,0,0,0,0,0,0,0,0,0,0,0,0,0,0,0,0,0,0,0,0,0,0,0,0,0,0,9007,9007,9007,9007,0,0,0,0,0,0,0,0,0,0
0,0,0,0,0,0,9011,9011,9011,0,0,0,0,0,0,0,9004,9004,9004,9004,9004,9004,9004,9004,0,0,0,0,0,0,0,0,0,0,0,0,0,0,0,0,0,0,0,0,0,0,0,0,0,0,9007,9007,9007,9007,0,0,0,0,0,0,0,0,0,0
0,0,0,0,0,0,9011,9011,9011,0,0,0,0,0,0,0,9004,9004,9004,9004,9004,9004,9004,9004,0,0,0,0,0,0,0,0,0,0,0,0,0,0,0,0,0,0,0,0,0,0,0,0,0,0,9007,9007,9007,9007,0,0,0,0,0,0,0,0,0,0
0,0,0,0,0,0,9011,9011,9011,0,0,0,0,0,0,0,9004,9004,9004,9004,9004,9004,9004,9004,0,0,0,0,0,0,0,0,0,0,0,0,0,0,0,0,0,0,0,0,0,0,0,0,0,0,9007,9007,9007,9007,0,0,0,0,0,0,0,0,0,0
0,0,0,0,0,0,9011,9011,9011,0,0,0,0,0,0,0,9004,9004,9004,9004,9004,9004,9004,9004,0,0,0,0,0,0,0,0,0,0,0,0,0,0,0,0,0,0,0,0,0,0,0,0,0,0,9007,9007,9007,9007,0,0,0,0,0,0,0,0,0,0
0,0,0,0,0,0,9011,9011,9011,0,0,0,0,0,0,0,9004,9004,9004,9004,9004,9004,9004,9004,0,0,0,0,0,0,0,0,0,0,0,0,0,0,0,0,0,0,0,0,0,0,0,0,0,0,9007,9007,9007,9007,0,0,0,0,0,0,0,0,0,0
0,0,0,0,0,0,9011,9011,9011,0,0,0,0,0,0,0,0,0,0,0,0,0,0,0,0,0,0,0,0,0,0,0,0,0,0,0,0,0,0,0,0,0,0,0,0,0,0,0,0,0,9007,9007,9007,9007,0,0,0,0,0,0,0,0,0,0
0,0,0,0,0,0,9011,9011,9011,0,0,0,0,0,0,0,9003,9003,9003,9003,9003,9003,9003,9003,9003,9003,9003,9003,9003,9003,9003,0,0,0,0,0,0,0,0,0,0,0,0,0,0,0,0,0,0,0,9007,9007,9007,9007,0,0,0,0,0,0,0,0,0,0
0,0,0,0,0,0,9011,9011,9011,0,0,0,0,0,0,0,9003,9003,9003,9003,9003,9003,9003,9003,9003,9003,9003,9003,9003,9003,9003,0,0,0,0,0,0,0,0,0,0,0,0,0,0,0,0,0,0,0,9007,9007,9007,9007,0,0,0,0,0,0,0,0,0,0
0,0,0,0,0,0,9011,9011,9011,0,0,0,0,0,0,0,9003,9003,9003,9003,9003,9003,9003,9003,9003,9003,9003,9003,9003,9003,9003,0,0,9005,9005,9005,9005,9005,9005,9005,9005,9005,0,0,0,0,0,0,0,0,9007,9007,9007,9007,0,0,0,0,0,0,0,0,0,0
0,0,0,0,0,0,9011,9011,9011,0,0,0,0,0,0,0,9003,9003,9003,9003,9003,9003,9003,9003,9003,9003,9003,9003,9003,9003,9003,0,9005,9005,9005,9005,9005,9005,9005,9005,9005,9005,0,0,0,0,0,0,0,0,9007,9007,9007,9007,0,0,0,0,0,0,0,0,0,0
0,0,0,0,0,0,9011,9011,9011,0,0,0,0,0,0,0,9003,9003,9003,9003,9003,9003,9003,9003,9003,9003,9003,9003,9003,9003,9003,0,9005,9005,9005,9005,9005,9005,9005,9005,9005,9005,0,0,0,0,0,0,0,0,9007,9007,9007,9007,0,0,0,0,0,0,0,0,0,0
0,0,0,0,0,0,9011,9011,9011,0,0,0,0,0,0,0,9003,9003,9003,9003,9003,9003,9003,9003,9003,9003,9003,9003,9003,9003,9003,0,9005,9005,9005,9005,9005,9005,9005,9005,9005,9005,0,0,0,0,0,0,0,0,0,0,0,0,0,0,0,0,0,0,0,0,0,0
0,0,0,0,0,0,9011,9011,9011,0,0,0,0,0,0,0,9003,9003,9003,9003,9003,9003,9003,9003,9003,9003,9003,9003,9003,9003,9003,0,0,9005,9005,9005,9005,9005,9005,9005,9005,9005,0,9006,9006,9006,9006,9006,9006,9006,9006,9006,9006,9006,9006,9006,9006,9006,0,0,0,0,0,0
0,0,0,0,0,0,9011,9011,9011,0,0,0,0,0,0,0,0,0,0,0,0,0,0,0,0,0,0,0,0,0,0,0,0,9005,9005,9005,9005,9005,9005,9005,9005,9005,0,9006,9006,9006,9006,9006,9006,9006,9006,9006,9006,9006,9006,9006,9006,9006,0,0,0,0,0,0
0,0,0,0,0,0,9011,9011,9011,0,0,0,0,0,0,0,0,0,0,0,0,0,0,0,9002,9002,9002,0,0,0,0,0,0,9005,9005,9005,9005,9005,9005,9005,9005,9005,0,9006,9006,9006,9006,9006,9006,9006,9006,9006,9006,9006,9006,9006,9006,9006,0,0,0,0,0,0
0,0,0,0,0,0,9011,9011,9011,0,0,0,0,0,0,0,0,0,0,0,0,0,0,0,9002,9002,9002,0,0,9005,9005,9005,9005,9005,9005,9005,9005,9005,9005,9005,9005,9005,0,0,0,0,0,0,0,0,0,0,9006,9006,9006,9006,9006,9006,0,0,0,0,0,0
0,0,0,0,0,0,9011,9011,9011,0,0,0,0,0,0,0,0,0,0,0,0,0,0,0,9002,9002,9002,0,0,9005,9005,9005,9005,9005,9005,9005,9005,9005,9005,9005,9005,9005,0,0,0,0,0,0,0,0,0,0,9006,9006,9006,9006,9006,9006,0,0,0,0,0,0
0,0,0,0,0,0,9011,9011,9011,0,0,0,0,0,0,0,0,0,0,0,0,0,0,0,9002,9002,9002,0,0,9005,9005,9005,9005,9005,9005,9005,9005,9005,9005,9005,9005,9005,0,0,0,0,0,0,0,0,0,0,9006,9006,9006,9006,9006,9006,0,0,0,0,0,0
0,0,0,0,0,0,0,0,0,0,0,0,0,0,0,0,0,0,0,0,0,0,0,0,9002,9002,9002,0,0,9005,9005,9005,9005,9005,9005,9005,9005,9005,9005,9005,9005,9005,0,0,0,0,0,0,0,0,0,0,9006,9006,9006,9006,9006,9006,0,0,0,0,0,0
0,0,0,0,9001,9001,9001,9001,9001,9001,9001,9001,0,0,0,0,0,0,0,0,0,0,0,0,9002,9002,9002,0,0,0,0,0,0,0,0,0,0,0,0,0,0,0,0,0,0,0,0,0,0,0,0,0,9006,9006,9006,9006,9006,9006,0,0,0,0,0,0
0,0,0,0,9001,9001,9001,9001,9001,9001,9001,9001,0,0,0,0,0,0,0,0,0,0,0,0,9002,9002,9002,0,0,0,0,0,0,0,0,0,0,0,0,0,0,0,0,0,0,0,0,0,0,0,0,0,9006,9006,9006,9006,9006,9006,0,0,0,0,0,0
0,0,0,0,9001,9001,9001,9001,9001,9001,9001,9001,0,9002,9002,9002,9002,9002,9002,9002,9002,9002,9002,9002,9002,9002,9002,0,0,0,0,0,0,0,0,0,0,0,0,0,0,0,0,0,0,0,0,0,0,0,0,0,9006,9006,9006,9006,9006,9006,0,0,0,0,0,0
0,0,0,0,9001,9001,9001,9001,9001,9001,9001,9001,0,9002,9002,9002,9002,9002,9002,9002,9002,9002,9002,9002,9002,9002,9002,0,0,0,0,0,0,0,0,0,0,0,0,0,0,0,0,0,0,0,0,0,0,0,0,0,9006,9006,9006,9006,9006,9006,0,0,0,0,0,0
0,0,0,0,9001,9001,9001,9001,9001,9001,9001,9001,0,9002,9002,9002,9002,9002,9002,9002,9002,9002,9002,9002,9002,9002,9002,0,0,0,0,0,0,0,0,0,0,0,0,0,0,0,0,0,0,9006,9006,9006,9006,9006,9006,9006,9006,9006,9006,9006,9006,9006,0,0,0,0,0,0
0,0,0,0,9001,9001,9001,9001,9001,9001,9001,9001,0,0,0,0,0,0,0,0,0,0,0,0,0,0,0,0,0,0,0,0,0,0,0,0,0,0,0,0,0,0,0,0,0,9006,9006,9006,9006,9006,9006,9006,9006,9006,9006,9006,9006,9006,0,0,0,0,0,0
0,0,0,0,9001,9001,9001,9001,9001,9001,9001,9001,0,0,0,0,0,0,0,0,0,0,0,0,0,0,0,0,0,0,0,0,0,0,0,0,0,0,0,0,0,0,0,0,0,9006,9006,9006,9006,9006,9006,9006,9006,9006,9006,9006,9006,9006,0,0,0,0,0,0
0,0,0,0,0,0,0,0,0,0,0,0,0,0,0,0,0,0,0,0,0,0,0,0,0,0,0,0,0,0,0,0,0,0,0,0,0,0,0,0,0,0,0,0,0,0,0,0,0,0,0,0,0,0,0,0,0,0,0,0,0,0,0,0
0,0,0,0,0,0,0,0,0,0,0,0,0,0,0,0,0,0,0,0,0,0,0,0,0,0,0,0,0,0,0,0,0,0,0,0,0,0,0,0,0,0,0,0,0,0,0,0,0,0,0,0,0,0,0,0,0,0,0,0,0,0,0,0
0,0,0,0,0,0,0,0,0,0,0,0,0,0,0,0,0,0,0,0,0,0,0,0,0,0,0,0,0,0,0,0,0,0,0,0,0,0,0,0,0,0,0,0,0,0,0,0,0,0,0,0,0,0,0,0,0,0,0,0,0,0,0,0
