64
1001
1001
0,1085,1085,1085,1085,1085,1085,1085,1085,1085,1085,1085,1085,1085,1085,1085,1085,1085,1085,1085,1085,1085,1085,1085,1085,1085,1085,1085,1085,1085,1085,1085,1085,1085,1085,1085,1085,1085,1085,1085,1085,1085,1085,1085,1085,1085,1085,1085,1085,1085,1085,1085,1085,1085,1085,1085,1085,1085,1085,1085,1085,0,0,0
0,1085,5006,0,0,0,0,0,0,0,0,0,0,0,0,0,0,5006,1085,5011,0,0,0,0,0,0,0,0,0,0,0,0,0,0,0,0,0,0,0,0,0,0,0,0,0,0,0,0,0,0,0,0,0,0,0,0,0,0,0,0,1085,0,0,0
0,1085,0,2036,0,0,0,0,0,0,0,0,0,0,0,0,2034,0,3001,0,2036,0,0,0,5004,0,0,0,0,0,0,0,0,0,0,0,0,0,0,0,5004,0,0,0,0,0,0,0,0,0,0,0,0,0,0,0,0,5004,2034,0,1085,0,0,0
0,1085,0,2006,0,0,5004,0,0,0,0,0,0,0,5004,0,2005,0,1085,0,2033,0,0,0,0,0,0,0,0,2015,0,0,0,0,0,0,0,0,0,0,0,0,0,0,0,0,0,0,0,0,0,0,0,0,0,2036,0,0,0,0,1085,0,0,0
0,1085,0,2033,0,0,0,0,0,0,0,0,0,0,0,0,2035,0,1085,5006,0,0,0,0,0,0,0,0,0,0,0,0,0,0,0,0,0,0,0,0,0,0,0,0,0,0,0,0,0,0,0,0,0,0,0,0,0,0,0,0,1085,0,0,0
0,1085,5006,0,0,0,0,0,0,0,0,0,0,0,0,0,0,5006,1085,1085,1085,1085,1085,1085,1085,1085,1085,1085,1085,1085,1085,1085,1085,1085,1085,1085,1085,1085,1085,1085,1085,1085,1085,1085,1085,1085,1085,1085,1085,1085,1085,1085,1085,1085,0,0,0,0,0,0,1085,0,0,0
0,1085,1085,1085,1085,1085,1085,1085,1085,3002,1085,1085,1085,1085,1085,1085,1085,1085,1085,5006,0,0,0,0,5006,1085,0,0,0,0,0,0,0,0,0,0,0,0,0,0,0,0,0,0,0,0,0,0,0,0,0,0,5008,1085,0,0,0,0,0,0,1085,0,0,0
0,1085,0,0,0,0,0,0,0,0,0,0,0,0,0,0,0,0,1085,0,0,5004,0,0,0,1085,0,0,0,0,0,0,0,0,0,0,0,0,0,0,0,0,0,0,0,0,0,0,0,0,0,0,0,1085,0,2014,0,0,0,0,1085,0,0,0
0,1085,0,0,0,0,0,0,0,0,0,0,0,0,0,0,0,0,3001,0,0,0,0,0,0,3001,0,0,0,0,5004,0,0,0,2004,0,0,0,0,0,0,0,5004,0,0,0,0,0,0,5008,0,0,0,1085,0,0,0,0,0,0,1085,0,0,0
0,1085,0,0,0,5004,0,0,0,2017,0,0,0,0,5004,0,0,0,1085,0,0,0,0,0,0,1085,0,0,0,0,0,0,0,0,0,0,0,0,0,0,0,0,0,0,0,0,0,0,0,0,0,0,0,1085,0,0,0,0,0,0,1085,0,0,0
0,1085,0,0,0,0,0,0,0,0,0,0,0,0,0,0,0,0,1085,0,0,0,0,0,0,1085,1085,1085,1085,1085,1085,1085,1085,1085,1085,1085,1085,1085,1085,1085,1085,1085,1085,1085,1085,1085,1085,1085,0,0,5004,0,0,1085,0,0,0,0,0,0,1085,0,0,0
0,1085,1085,1085,1085,1085,1085,1085,1085,1085,1085,1085,1085,1085,1085,1085,1085,1085,1085,0,0,0,0,0,0,1085,0,0,0,0,4003,1085,5001,5007,0,0,0,1085,4012,0,0,5005,0,0,0,5008,0,5005,0,0,0,0,0,1085,0,0,0,5004,0,0,1085,0,0,0
0,1085,0,0,5005,0,0,0,0,0,0,0,0,5005,0,0,0,0,1085,0,0,0,0,0,0,1085,0,0,0,0,0,1085,5007,5007,0,0,0,1085,0,0,0,5005,0,0,0,0,0,5005,0,0,0,0,0,1085,0,0,0,0,0,0,1085,0,0,0
0,1085,0,0,0,0,0,5005,0,0,0,0,0,0,0,0,0,4007,1085,0,0,5004,0,0,0,1085,4008,0,5004,0,0,3001,0,0,2025,0,0,3001,0,5008,0,5005,0,5004,5005,0,0,5005,0,0,0,5008,0,1085,0,0,0,0,0,0,1085,0,0,0
0,1085,0,0,4012,0,0,0,0,0,0,4003,0,0,0,0,0,0,1085,0,0,0,0,0,0,1085,0,0,0,0,0,1085,0,0,0,0,0,1085,0,0,0,0,0,0,5005,0,0,0,0,5008,0,0,0,1085,0,0,0,0,0,0,1085,0,0,0
0,1085,0,0,0,0,0,0,0,0,0,0,0,5005,0,0,0,0,1085,5006,0,0,0,0,5006,1085,0,0,0,0,4007,1085,0,0,0,0,0,1085,4002,5008,0,0,0,0,5005,0,0,0,0,0,0,0,0,1085,0,0,0,0,0,0,1085,0,0,0
0,1085,1085,1085,1085,1085,1085,1085,1085,3002,1085,1085,1085,1085,1085,1085,1085,1085,1085,1085,1085,1085,1085,1085,1085,1085,1085,1085,1085,1085,1085,1085,1085,1085,1085,1085,1085,1085,1085,1085,1085,1085,1085,1085,1085,1085,1085,1085,1085,1085,1085,1085,1085,1085,0,0,0,0,0,0,1085,0,0,0
1084,1084,1084,1084,1084,1084,1084,1084,5006,0,5006,1084,1084,1084,1084,1084,1084,1084,1084,1084,1084,1084,1084,1084,1084,1084,1084,1084,1084,1084,1084,1084,1084,1084,1084,1084,1084,1084,1084,1085,5011,0,0,0,0,0,0,0,0,0,0,0,0,0,0,0,0,0,0,0,1085,0,0,0
1084,0,2036,0,0,0,0,0,0,0,0,0,0,0,0,0,0,0,2034,0,1084,5006,2036,0,0,0,0,0,0,0,0,0,0,0,0,0,0,2034,0,1085,0,2036,0,0,0,0,0,0,0,0,0,0,0,0,0,2034,0,0,0,0,1085,0,0,0
1084,0,0,0,0,0,0,0,0,0,0,0,0,0,0,0,0,0,2005,0,1084,0,2006,0,0,0,0,0,0,0,0,0,0,0,0,0,0,0,0,3005,0,0,0,0,0,5004,0,0,0,0,0,0,0,0,0,0,0,5004,0,0,1085,0,0,0
1084,0,0,5004,0,0,0,0,0,0,0,0,0,0,0,5004,0,0,0,0,3003,0,0,0,0,0,5004,0,0,0,0,0,0,0,0,5004,0,0,0,1085,0,2033,0,0,0,0,0,0,0,0,0,2015,0,0,0,0,0,0,2035,0,1085,0,0,0
1084,0,0,0,0,2033,0,0,0,0,0,0,0,0,0,0,0,0,2035,0,1084,0,2033,0,0,0,0,0,0,0,0,0,0,0,2036,0,0,0,1084,1085,4012,0,0,0,0,0,0,0,0,0,0,0,0,0,0,0,0,0,0,0,1085,0,0,0
1084,0,2014,0,0,0,0,0,0,0,0,0,0,0,0,0,0,0,0,4012,1084,5006,0,0,0,0,0,0,0,0,0,0,0,0,0,0,0,0,1084,1085,1085,1085,1085,1085,1085,1085,1085,1085,1085,1085,1085,1085,1085,1085,1085,1085,1085,1085,1085,1085,1085,0,0,0
1084,0,0,0,0,0,0,1084,1084,1084,1084,1084,1084,1084,1084,1084,1084,1084,1084,1084,1084,1084,1084,1084,1084,1084,1084,1084,1084,1084,1084,1084,1084,0,0,0,0,0,1084,0,0,0,0,0,0,0,0,0,0,0,0,0,0,0,0,0,0,0,0,0,0,0,0,0
1084,0,0,0,0,0,0,1084,0,0,0,0,0,0,0,0,0,0,0,0,0,0,0,0,0,0,0,0,0,0,0,0,1084,0,0,0,0,0,1084,0,0,0,0,0,0,0,0,0,0,0,0,0,0,0,0,0,0,0,0,0,0,0,0,0
1084,0,0,0,0,0,0,1084,0,0,0,0,0,0,0,0,0,0,0,0,1082,1082,1082,1082,1082,1082,1082,0,0,0,0,0,1084,0,0,5004,0,2005,1084,0,0,0,0,0,0,0,0,0,0,0,0,0,0,0,0,0,0,0,0,0,0,0,0,0
1084,0,0,0,0,0,0,1084,0,0,0,0,0,0,0,0,0,0,0,0,1082,0,0,2017,0,0,1082,0,0,0,0,0,1084,0,0,0,0,0,1084,0,0,0,0,0,0,0,0,0,0,0,0,0,0,0,0,0,0,0,0,0,0,0,0,0
1084,0,0,0,0,0,0,1084,0,0,0,0,0,0,0,0,0,0,0,0,1082,0,0,5004,0,0,1082,0,0,0,0,0,1084,0,2033,0,0,2035,1084,0,0,0,0,0,0,0,0,0,0,0,0,0,0,0,0,0,0,0,0,0,0,0,0,0
1084,0,0,0,0,0,0,1084,0,0,0,0,0,0,0,0,0,0,0,0,1082,4003,0,0,0,4007,1082,0,0,0,0,0,1084,5006,0,0,0,5006,1084,0,0,0,0,0,0,0,0,0,0,0,0,0,0,0,0,0,0,0,0,0,0,0,0,0
1084,0,0,0,0,0,0,1084,0,0,0,0,0,0,1082,1082,1082,1082,1082,1082,1082,1082,1082,3002,1082,1082,1082,1082,1082,1082,1082,1082,1082,1084,1084,3002,1084,1084,1084,1083,1083,1083,1083,1083,1083,1083,1083,1083,1083,1083,1083,1083,1083,1083,1083,1083,1083,1083,1083,1083,1083,0,0,0
1084,0,0,5004,0,0,0,1084,0,0,0,0,0,0,1082,0,0,0,0,0,1082,5002,0,0,0,5002,1082,0,2006,0,0,0,1082,5002,0,0,0,5002,1082,1083,5003,0,0,5003,1083,0,2036,0,0,0,0,0,0,0,0,0,0,2034,0,4012,1083,0,0,0
1084,0,0,0,0,0,0,1084,0,0,0,0,0,0,1082,0,2036,0,2034,0,1082,0,0,0,0,0,1082,0,2036,0,2034,0,1082,0,2036,0,2034,0,1082,1083,0,0,2010,0,3001,0,2022,0,0,0,5004,0,0,0,5004,0,0,2021,5001,4009,1083,0,0,0
1084,0,0,0,0,0,0,1084,0,0,0,0,0,0,1082,0,0,0,0,0,3001,0,0,0,0,0,3001,0,0,0,0,0,1082,0,0,0,0,0,1082,1083,0,0,0,0,1083,0,2033,0,0,0,0,0,0,0,0,0,0,2035,0,4002,1083,0,0,0
1084,0,0,0,0,2013,0,1084,0,0,0,0,0,0,1082,0,2014,0,0,0,1082,0,0,0,0,0,1082,0,0,0,0,0,1082,0,0,0,0,0,1082,1083,0,5004,0,0,1083,1083,1083,1083,1083,1083,1083,1083,1083,1083,1083,1083,1083,1083,1083,1083,1083,0,0,0
1084,0,0,0,0,0,0,1084,0,0,0,0,0,0,1082,0,5004,4001,0,0,1082,0,0,0,0,0,1082,0,0,4012,5004,0,1082,0,0,5004,0,0,1082,1083,0,0,0,0,1083,0,0,0,0,0,0,0,0,0,0,0,0,0,0,0,1083,0,0,0
1084,0,0,0,0,0,0,1084,0,0,0,0,0,0,1082,0,0,0,0,0,1082,0,0,5004,0,0,1082,0,0,0,0,0,1082,0,0,0,0,0,1082,1083,5007,0,4006,0,3001,0,0,5004,0,0,0,0,0,0,0,0,0,5004,0,0,1083,0,0,0
1084,0,0,0,0,0,0,1084,0,0,0,0,0,0,1082,0,0,0,2005,0,1082,0,0,0,0,0,1082,0,0,0,0,0,1082,0,0,0,0,0,1082,1083,0,0,0,0,1083,0,0,0,0,0,0,0,0,0,0,0,0,0,0,0,1083,0,0,0
1084,0,0,0,0,0,0,1084,0,0,0,0,0,0,1082,0,2033,0,2035,0,3001,0,0,0,0,0,3001,0,2033,0,2035,0,1082,0,0,0,0,0,1082,1083,4002,0,0,4012,1083,0,0,0,0,0,0,0,2004,0,0,0,0,0,0,0,1083,0,0,0
1084,0,0,0,0,0,0,1084,0,0,0,0,0,0,1082,0,0,0,0,0,1082,0,0,0,0,0,1082,0,0,0,0,0,1082,0,0,0,0,0,1082,1083,1083,1083,1083,1083,1083,1083,1083,1083,1083,3002,1083,1083,1083,1083,1083,1083,1083,1083,1083,1083,1083,0,0,0
1084,0,2033,0,0,2035,0,1084,0,0,0,1082,1082,1082,1082,1082,1082,1082,1082,1082,1082,0,0,0,0,0,1082,1082,1082,1082,1082,1082,1082,0,0,0,0,0,1082,1083,0,0,0,0,0,0,0,0,0,0,0,0,0,0,0,1083,0,2041,0,5001,1083,0,0,0
1084,0,0,0,0,0,0,1084,1082,1082,1082,1082,0,0,0,0,0,0,0,0,0,0,0,0,0,0,0,0,0,0,0,0,1082,0,0,0,0,0,1082,1083,0,0,5004,0,0,0,0,0,0,0,0,0,5004,0,0,1083,0,5004,0,0,1083,0,0,0
1084,5003,0,0,0,5003,0,1084,1082,2002,0,1082,0,2036,0,0,0,0,0,0,0,0,0,0,0,0,0,0,0,0,2034,0,1082,0,0,0,0,0,1082,1083,2003,0,0,0,0,0,0,0,0,0,0,0,0,0,0,1083,0,0,0,0,1083,0,0,0
1084,1084,1084,3002,1084,1084,1084,1084,1082,0,0,1082,0,0,0,0,0,5004,0,0,0,0,0,5004,0,0,0,0,5004,0,0,0,1082,0,0,0,0,0,1082,1083,0,0,0,0,0,0,0,0,0,0,0,0,0,0,0,1083,1083,3002,1083,1083,1083,0,0,0
1084,0,0,0,0,0,0,1084,1082,0,0,3001,0,0,0,0,0,0,0,0,0,0,0,0,0,0,0,0,0,0,0,0,3001,0,0,0,0,2013,1082,1083,1083,1083,1083,3002,1083,1083,1083,1083,1083,1083,1083,1083,1083,1083,1083,1083,4012,0,0,4007,1083,0,0,0
1084,0,0,2025,0,0,0,1084,1082,0,0,1082,0,2033,2015,0,0,0,0,0,0,0,0,0,0,0,0,0,0,0,2035,0,1082,0,0,0,0,0,1082,1083,0,0,0,0,0,0,0,0,0,0,0,0,0,0,0,1083,4003,0,0,4003,1083,0,0,0
1084,0,1012,3002,1012,0,0,1084,1082,0,0,1082,1082,1082,1082,1082,1082,1082,1082,1082,1082,1082,0,0,0,0,0,1082,1082,1082,1082,1082,1082,1082,0,5004,0,0,1082,1083,0,0,5004,0,0,0,0,0,0,0,0,0,5004,0,2004,1083,0,5004,0,0,1083,0,0,0
1084,5003,1012,4011,1012,5003,0,1084,1082,0,0,0,0,0,0,1082,1083,1083,1083,1083,1083,1083,1083,1083,3002,1083,1083,1083,1083,1083,1083,1083,1083,1082,0,0,0,0,1082,1083,0,0,0,0,0,0,0,0,0,0,0,0,0,0,0,1083,0,0,0,0,1083,0,0,0
1084,1084,1012,1012,1012,1084,1084,1084,1082,0,0,0,0,0,0,1082,1083,0,2002,0,5007,1083,4002,0,0,0,4002,1083,5001,0,2002,0,1083,1082,0,0,0,0,1082,1083,1083,1083,1083,1083,1083,1083,1083,1083,1083,3002,1083,1083,1083,1083,1083,1083,1083,3002,1083,1083,1083,0,0,0
0,0,0,0,0,0,0,0,1082,0,0,0,0,5004,0,1082,1083,0,0,0,5001,1083,0,0,0,0,0,1083,0,0,0,0,1083,1082,0,0,0,0,1082,1083,4003,4003,4007,4012,1083,0,0,0,0,0,0,0,0,0,0,0,0,0,0,0,1083,0,0,0
0,0,0,0,0,0,0,0,1082,1082,1082,1082,0,0,0,1082,1083,0,5004,0,0,1083,0,0,5004,0,0,1083,0,0,5004,0,1083,1082,2014,0,0,0,1082,1083,0,0,0,0,1083,0,0,0,5004,0,0,0,0,0,0,0,5004,0,0,2004,1083,0,0,0
1081,1081,1081,1081,1081,1081,1081,1081,1081,1081,1081,1081,1081,3002,1081,1081,1083,0,0,0,4012,1083,0,0,0,0,0,1083,4012,0,0,5007,1083,1082,0,0,0,0,1082,1083,0,5004,0,0,3001,0,0,0,0,0,0,0,0,0,0,0,0,0,0,0,1083,0,0,0
1081,2036,2036,1081,5001,0,5007,1081,0,2002,0,1081,0,0,0,1081,1083,1083,3002,1083,1083,1083,0,0,0,0,0,1083,1083,1083,3002,1083,1083,1082,0,0,0,0,1082,1083,0,0,0,0,1083,0,0,0,0,0,0,0,0,0,0,0,0,0,0,0,1083,0,0,0
1081,2006,0,1081,0,4005,0,1081,0,0,0,1081,0,0,0,1081,1083,0,0,0,0,1083,0,0,2009,0,0,1083,0,0,0,0,1083,1082,0,0,0,0,1082,1083,1083,3002,1083,1083,1083,1083,1083,1083,1083,1083,1083,1083,3002,1083,1083,1083,1083,1083,1083,1083,1083,0,0,0
1081,0,0,1081,0,0,0,1081,5007,0,0,1081,0,5004,0,1081,1083,0,5004,0,0,1083,0,0,0,0,0,1083,5007,0,5004,0,1083,1082,0,0,0,0,1082,1083,0,0,0,5001,1083,0,0,0,0,0,0,0,0,0,0,0,0,0,0,0,1083,0,0,0
1081,0,0,1081,1081,3002,1081,1081,1081,3002,1081,1081,0,0,0,1081,1083,5007,0,0,0,1083,0,0,5004,0,0,1083,0,0,0,0,1083,1082,0,0,0,0,1082,1083,0,5004,0,0,1083,2003,0,0,5004,0,0,0,0,0,0,0,5004,0,0,0,1083,0,0,0
1081,0,0,0,0,0,0,0,0,0,5003,1081,0,0,0,1081,1083,0,0,0,2004,1083,0,0,0,0,0,1083,2003,0,0,0,1083,1082,0,0,0,0,1082,1083,0,2041,0,5007,1083,0,0,0,0,0,0,0,0,0,0,0,0,0,0,0,1083,0,0,0
1081,5004,0,0,0,0,0,5004,0,0,0,3001,0,0,0,1081,1083,1083,3002,1083,1083,1083,0,0,0,0,0,1083,1083,1083,3002,1083,1083,1082,0,5004,0,0,1082,1083,1083,1083,1083,1083,1083,1083,1083,1083,1083,1083,1083,1083,3002,1083,1083,1083,1083,1083,1083,1083,1083,0,0,0
1081,0,0,0,0,0,0,0,0,0,0,1081,0,0,0,1081,1083,0,0,0,5007,1083,0,0,0,0,0,1083,0,0,0,0,1083,1082,0,0,0,0,1082,1082,1082,1082,1082,1082,1082,1082,1082,1082,1082,1082,5003,0,0,0,5003,1082,1082,1082,1082,1082,1082,0,0,0
1081,0,0,1081,1081,3002,1081,1081,1081,3002,1081,1081,0,0,0,1081,1083,0,0,0,0,1083,1083,1083,3002,1083,1083,1083,5007,0,0,0,1083,1082,0,0,2035,0,0,0,0,0,0,0,0,0,0,0,0,0,0,0,0,0,0,0,0,0,2034,0,1082,0,0,0
1081,0,0,1081,0,0,0,1081,0,0,5007,1081,0,5004,0,1081,1083,0,5004,0,0,1083,0,0,0,5007,0,1083,0,0,5004,0,1083,1082,0,0,0,0,0,0,0,0,0,0,0,0,0,0,0,0,0,0,0,0,0,0,0,0,0,0,1082,0,0,0
1081,0,2005,1081,0,4012,0,1081,0,4002,0,1081,0,0,0,1081,1083,0,0,0,0,3001,0,0,5004,0,0,3001,0,0,0,0,1083,1082,2033,0,0,0,0,0,0,0,0,5004,0,2015,0,0,0,0,0,0,5004,0,0,0,0,0,2035,0,1082,0,0,0
1081,2035,2035,1081,0,0,5007,1081,0,0,0,1081,0,4010,0,1081,1083,0,0,0,0,1083,0,0,2009,0,0,1083,0,0,0,0,1083,1082,0,0,0,0,0,0,0,0,0,0,0,0,0,0,0,0,0,0,0,0,0,0,0,0,0,0,1082,0,0,0
1081,1081,1081,1081,1081,1081,1081,1081,1081,1081,1081,1081,1081,1081,1081,1081,1083,1083,1083,1083,1083,1083,1083,1083,1083,1083,1083,1083,1083,1083,1083,1083,1083,1082,1082,1082,1082,1082,1082,1082,1082,1082,1082,1082,1082,1082,1082,1082,1082,1082,1082,1082,1082,1082,1082,1082,1082,1082,1082,1082,1082,0,0,0
0,0,0,0,0,0,0,0,0,0,0,0,0,0,0,0,0,0,0,0,0,0,0,0,0,0,0,0,0,0,0,0,0,0,0,0,0,0,0,0,0,0,0,0,0,0,0,0,0,0,0,0,0,0,0,0,0,0,0,0,0,0,0,0

0,0,0,0,0,0,0,0,0,0,0,0,0,0,0,0,0,0,0,0,0,0,0,0,0,0,0,0,0,0,0,0,0,0,0,0,0,0,0,0,0,0,0,0,0,0,0,0,0,0,0,0,0,0,0,0,0,0,0,0,0,0,0,0
0,0,9030,9030,9030,9030,9030,9030,9030,9030,9030,9030,9030,9030,9030,9030,9030,9030,0,9029,9029,9029,9029,9029,9029,9029,9029,9029,9029,9029,9029,9029,9029,9029,9029,9029,9029,9029,9029,9029,9029,9029,9029,9029,9029,9029,9029,9029,9029,9029,9029,9029,9029,9029,9029,9029,9029,9029,9029,9029,0,0,0,0
0,0,9030,9030,9030,9030,9030,9030,9030,9030,9030,9030,9030,9030,9030,9030,9030,9030,0,9029,9029,9029,9029,9029,9029,9029,9029,9029,9029,9029,9029,9029,9029,9029,9029,9029,9029,9029,9029,9029,9029,9029,9029,9029,9029,9029,9029,9029,9029,9029,9029,9029,9029,9029,9029,9029,9029,9029,9029,9029,0,0,0,0
0,0,9030,9030,9030,9030,9030,9030,9030,9030,9030,9030,9030,9030,9030,9030,9030,9030,0,9029,9029,9029,9029,9029,9029,9029,9029,9029,9029,9029,9029,9029,9029,9029,9029,9029,9029,9029,9029,9029,9029,9029,9029,9029,9029,9029,9029,9029,9029,9029,9029,9029,9029,9029,9029,9029,9029,9029,9029,9029,0,0,0,0
0,0,9030,9030,9030,9030,9030,9030,9030,9030,9030,9030,9030,9030,9030,9030,9030,9030,0,9029,9029,9029,9029,9029,9029,9029,9029,9029,9029,9029,9029,9029,9029,9029,9029,9029,9029,9029,9029,9029,9029,9029,9029,9029,9029,9029,9029,9029,9029,9029,9029,9029,9029,9029,9029,9029,9029,9029,9029,9029,0,0,0,0
0,0,9030,9030,9030,9030,9030,9030,9030,9030,9030,9030,9030,9030,9030,9030,9030,9030,0,0,0,0,0,0,0,0,0,0,0,0,0,0,0,0,0,0,0,0,0,0,0,0,0,0,0,0,0,0,9029,0,0,0,0,0,9029,9029,9029,9029,9029,9029,0,0,0,0
0,0,0,0,0,0,0,0,0,0,0,0,0,0,0,0,0,0,0,9032,9032,9032,9032,9032,9032,0,9033,9033,9033,9033,9033,9033,9033,9033,9033,9033,9033,9033,9033,9033,9033,9033,9033,9033,9033,9033,9033,9033,9033,9033,9033,9033,9033,0,9029,9029,9029,9029,9029,9029,0,0,0,0
0,0,9031,9031,9031,9031,9031,9031,9031,9031,9031,9031,9031,9031,9031,9031,9031,9031,0,9032,9032,9032,9032,9032,9032,0,9033,9033,9033,9033,9033,9033,9033,9033,9033,9033,9033,9033,9033,9033,9033,9033,9033,9033,9033,9033,9033,9033,9033,9033,9033,9033,9033,0,9029,9029,9029,9029,9029,9029,0,0,0,0
0,0,9031,9031,9031,9031,9031,9031,9031,9031,9031,9031,9031,9031,9031,9031,9031,9031,0,9032,9032,9032,9032,9032,9032,0,9033,9033,9033,9033,9033,9033,9033,9033,9033,9033,9033,9033,9033,9033,9033,9033,9033,9033,9033,9033,9033,9033,9033,9033,9033,9033,9033,0,9029,9029,9029,9029,9029,9029,0,0,0,0
0,0,9031,9031,9031,9031,9031,9031,9031,9031,9031,9031,9031,9031,9031,9031,9031,9031,0,9032,9032,9032,9032,9032,9032,0,9033,9033,9033,9033,9033,9033,9033,9033,9033,9033,9033,9033,9033,9033,9033,9033,9033,9033,9033,9033,9033,9033,9033,9033,9033,9033,9033,0,9029,9029,9029,9029,9029,9029,0,0,0,0
0,0,9031,9031,9031,9031,9031,9031,9031,9031,9031,9031,9031,9031,9031,9031,9031,9031,0,9032,9032,9032,9032,9032,9032,0,0,0,0,0,0,0,0,0,0,0,0,0,0,0,0,0,0,0,0,0,0,0,9033,9033,9033,9033,9033,0,9029,9029,9029,9029,9029,9029,0,0,0,0
0,0,0,0,0,0,0,0,0,0,0,0,0,0,0,0,0,0,0,9032,9032,9032,9032,9032,9032,0,9035,9035,9035,9035,9035,0,9034,9034,9034,9034,9034,0,9033,9033,9033,9033,9033,9033,9033,9033,9033,9033,9033,9033,9033,9033,9033,0,9029,9029,9029,9029,9029,9029,0,0,0,0
0,0,9037,9037,9037,9037,9037,9037,9037,9037,9037,9037,9037,9037,9037,9037,9037,9037,0,9032,9032,9032,9032,9032,9032,0,9035,9035,9035,9035,9035,0,9034,9034,9034,9034,9034,0,9033,9033,9033,9033,9033,9033,9033,9033,9033,9033,9033,9033,9033,9033,9033,0,9029,9029,9029,9029,9029,9029,0,0,0,0
0,0,9037,9037,9037,9037,9037,9037,9037,9037,9037,9037,9037,9037,9037,9037,9037,9037,0,9032,9032,9032,9032,9032,9032,0,9035,9035,9035,9035,9035,0,9034,9034,9034,9034,9034,0,9033,9033,9033,9033,9033,9033,9033,9033,9033,9033,9033,9033,9033,9033,9033,0,9029,9029,9029,9029,9029,9029,0,0,0,0
0,0,9037,9037,9037,9037,9037,9037,9037,9037,9037,9037,9037,9037,9037,9037,9037,9037,0,9032,9032,9032,9032,9032,9032,0,9035,9035,9035,9035,9035,0,9034,9034,9034,9034,9034,0,9033,9033,9033,9033,9033,9033,9033,9033,9033,9033,9033,9033,9033,9033,9033,0,9029,0,9029,9029,9029,9029,0,0,0,0
0,0,9037,9037,9037,9037,9037,9037,9037,9037,9037,9037,9037,9037,9037,9037,9037,9037,0,9032,9032,9032,9032,9032,9032,0,9035,9035,9035,9035,9035,0,9034,9034,9034,9034,9034,0,9033,9033,9033,9033,9033,9033,9033,9033,9033,9033,9033,9033,9033,9033,9033,0,9029,9029,9029,9029,9029,9029,0,0,0,0
0,0,0,0,0,0,0,0,0,0,0,0,0,0,0,0,0,0,0,0,0,0,0,0,0,0,0,0,0,0,0,0,0,0,0,0,0,0,0,0,0,0,0,0,0,0,0,0,0,0,0,0,0,0,9029,9029,9029,9029,9029,9029,0,0,0,0
0,0,0,0,0,0,0,0,9036,9036,9036,0,0,0,0,0,0,0,0,0,0,0,0,0,0,0,0,0,0,0,0,0,0,0,0,0,0,0,0,0,9029,9029,9029,9029,9029,9029,9029,9029,9029,9029,9029,9029,9029,9029,9029,9029,9029,9029,9029,9029,0,0,0,0
0,9036,9036,9036,9036,9036,9036,9036,9036,9036,9036,9036,9036,9036,9036,9036,9036,9036,9036,9036,0,9028,9028,9028,9028,9028,9028,9028,9028,9028,9028,9028,9028,9028,9028,9028,9028,9028,9028,0,9029,9029,9029,9029,9029,9029,9029,9029,9029,9029,9029,9029,9029,9029,9029,9029,9029,9029,9029,9029,0,0,0,0
0,9036,9036,9036,9036,9036,9036,9036,9036,9036,9036,9036,9036,9036,9036,9036,9036,9036,9036,9036,0,9028,9028,9028,9028,9028,9028,9028,9028,9028,9028,9028,9028,9028,9028,9028,9028,9028,9028,0,9029,9029,9029,9029,9029,9029,9029,9029,9029,9029,9029,9029,9029,9029,9029,9029,9029,9029,9029,9029,0,0,0,0
0,9036,9036,9036,9036,9036,9036,9036,9036,9036,9036,9036,9036,9036,9036,9036,9036,9036,9036,9036,0,9028,9028,9028,9028,9028,9028,9028,9028,9028,9028,9028,9028,9028,9028,9028,9028,9028,9028,0,9029,9029,9029,9029,9029,9029,9029,9029,9029,9029,9029,9029,9029,9029,9029,9029,9029,9029,9029,9029,0,0,0,0
0,9036,9036,9036,9036,9036,9036,9036,9036,9036,9036,9036,9036,9036,9036,9036,9036,9036,9036,9036,0,9028,9028,9028,9028,9028,9028,9028,9028,9028,9028,9028,9028,9028,9028,9028,9028,9028,9028,0,9029,9029,9029,9029,9029,9029,9029,9029,9029,9029,9029,9029,9029,9029,9029,9029,9029,9029,9029,9029,0,0,0,0
0,9036,9036,9036,9036,9036,9036,9036,9036,9036,9036,9036,9036,9036,9036,9036,9036,9036,9036,9036,0,9028,9028,9028,9028,9028,9028,9028,9028,9028,9028,9028,9028,9028,9028,9028,9028,9028,9028,0,0,0,0,0,0,0,0,0,0,0,0,0,0,0,0,0,0,0,0,0,0,0,0,0
0,9036,9036,9036,9036,9036,9036,0,0,0,0,0,0,0,0,0,0,0,0,0,0,0,0,0,0,0,0,0,0,0,0,0,0,9028,9028,9028,9028,9028,9028,0,0,0,0,0,0,0,0,0,0,0,0,0,0,0,0,0,0,0,0,0,0,0,0,0
0,9036,9036,9036,9036,9036,9036,0,0,0,0,0,0,0,0,0,0,0,0,0,0,0,0,0,0,0,0,0,0,0,0,0,0,9028,9028,9028,9028,9028,9028,0,0,0,0,0,0,0,0,0,0,0,0,0,0,0,0,0,0,0,0,0,0,0,0,0
0,9036,9036,9036,9036,9036,9036,0,0,0,0,0,0,0,0,0,0,0,0,0,0,0,0,0,0,0,0,0,0,0,0,0,0,9028,9028,9028,9028,9028,9028,0,0,0,0,0,0,0,0,0,0,0,0,0,0,0,0,0,0,0,0,0,0,0,0,0
0,9036,9036,9036,9036,9036,9036,0,0,0,0,0,0,0,0,0,0,0,0,0,0,9007,9007,9007,9007,9007,0,0,0,0,0,0,0,9028,9028,9028,9028,9028,9028,0,0,0,0,0,0,0,0,0,0,0,0,0,0,0,0,0,0,0,0,0,0,0,0,0
0,9036,9036,9036,9036,9036,9036,0,0,0,0,0,0,0,0,0,0,0,0,0,0,9007,9007,9007,9007,9007,0,0,0,0,0,0,0,9028,9028,9028,9028,9028,9028,0,0,0,0,0,0,0,0,0,0,0,0,0,0,0,0,0,0,0,0,0,0,0,0,0
0,9036,9036,9036,9036,9036,9036,0,0,0,0,0,0,0,0,0,0,0,0,0,0,9007,9007,9007,9007,9007,0,0,0,0,0,0,0,9028,9028,9028,9028,9028,9028,0,0,0,0,0,0,0,0,0,0,0,0,0,0,0,0,0,0,0,0,0,0,0,0,0
0,9036,9036,9036,9036,9036,9036,0,0,0,0,0,0,0,0,0,0,0,0,0,0,0,0,0,0,0,0,0,0,0,0,0,0,0,0,0,0,0,0,0,0,0,0,0,0,0,0,0,0,0,0,0,0,0,0,0,0,0,0,0,0,0,0,0
0,9036,9036,9036,9036,9036,9036,0,0,0,0,0,0,0,0,9005,9005,9005,9005,9005,0,9004,9004,9004,9004,9004,0,9006,9006,9006,9006,9006,0,0,9016,9016,9016,9016,0,0,9026,9026,9026,9026,0,9027,9027,9027,9027,9027,9027,9027,9027,9027,9027,9027,9027,9027,9027,9027,0,0,0,0
0,9036,9036,9036,9036,9036,9036,0,0,0,0,0,0,0,0,9005,9005,9005,9005,9005,0,9004,9004,9004,9004,9004,0,9006,9006,9006,9006,9006,0,0,0,9016,9016,9016,0,0,9026,9026,9026,9026,0,9027,9027,9027,9027,9027,9027,9027,9027,9027,9027,9027,9027,9027,9027,9027,0,0,0,0
0,9036,9036,9036,9036,9036,9036,0,0,0,0,0,0,0,0,9005,9005,9005,9005,9005,0,9004,9004,9004,9004,9004,0,9006,9006,9006,9006,9006,0,0,9016,0,9016,9016,0,0,9026,9026,9026,9026,0,9027,9027,9027,9027,9027,9027,9027,9027,9027,9027,9027,9027,9027,9027,9027,0,0,0,0
0,9036,9036,9036,9036,9036,9036,0,0,0,0,0,0,0,0,9005,9005,9005,9005,9005,0,9004,9004,9004,9004,9004,0,9006,9006,9006,9006,9006,0,0,9016,9016,9016,9016,0,0,9026,9026,9026,9026,0,0,0,0,0,0,0,0,0,0,0,0,0,0,0,0,0,0,0,0
0,9036,9036,9036,9036,9036,9036,0,0,0,0,0,0,0,0,9005,9005,9005,9005,9005,0,9004,9004,9004,9004,9004,0,9006,9006,9006,9006,9006,0,0,9016,9016,9016,9016,0,0,9026,9026,9026,9026,0,9025,9025,9025,9025,9025,9025,9025,9025,9025,9025,9025,9025,9025,9025,9025,0,0,0,0
0,9036,9036,9036,9036,9036,9036,0,0,0,0,0,0,0,0,9005,9005,9005,9005,9005,0,9004,9004,9004,9004,9004,0,9006,9006,9006,9006,9006,0,0,9016,9016,9016,9016,0,0,9026,9026,9026,9026,0,9025,9025,9025,9025,9025,9025,9025,9025,9025,9025,9025,9025,9025,9025,9025,0,0,0,0
0,9036,9036,9036,9036,9036,9036,0,0,0,0,0,0,0,0,9005,9005,9005,9005,9005,0,9004,9004,9004,9004,9004,0,9006,9006,9006,9006,9006,0,0,9016,9016,9016,9016,0,0,9026,9026,9026,9026,0,9025,9025,9025,9025,9025,9025,9025,9025,9025,9025,9025,9025,9025,9025,9025,0,0,0,0
0,9036,9036,9036,9036,9036,9036,0,0,0,0,0,0,0,0,9005,9005,9005,9005,9005,0,9004,9004,9004,9004,9004,0,9006,9006,9006,9006,9006,0,0,9016,9016,9016,9016,0,0,9026,9026,9026,9026,0,9025,9025,9025,9025,9025,9025,9025,9025,9025,9025,9025,9025,9025,9025,9025,0,0,0,0
0,9036,9036,9036,9036,9036,9036,0,0,0,0,0,0,0,0,9005,9005,9005,9005,9005,0,9004,9004,9004,9004,9004,0,9006,9006,9006,9006,9006,0,0,9016,9016,9016,9016,0,0,0,0,0,0,0,0,0,0,9011,0,0,0,0,0,0,0,0,0,0,0,0,0,0,0
0,9036,9036,9036,9036,9036,9036,0,0,0,0,0,0,0,0,0,0,0,0,0,0,9004,9004,9004,9004,9004,0,0,0,0,0,0,0,0,9016,9016,9016,9016,0,0,9024,9024,9024,9024,9024,9024,9024,9024,9024,9024,9024,9024,9024,9024,9024,0,9020,9020,9020,9020,0,0,0,0
0,9036,9036,9036,9036,9036,9036,0,0,0,0,0,9004,9004,9004,9004,9004,9004,9004,9004,9004,9004,9004,9004,9004,9004,9004,9004,9004,9004,9004,9004,0,9016,9016,9016,9016,9016,0,0,9024,9024,9024,9024,9024,9024,9024,9024,9024,9024,9024,9024,9024,9024,9024,0,9020,9020,9020,9020,0,0,0,0
0,9036,9036,9036,9036,9036,9036,0,0,9003,9003,0,9004,9004,9004,9004,9004,9004,9004,9004,9004,9004,9004,9004,9004,9004,9004,9004,9004,9004,9004,9004,0,9016,9016,9016,9016,9016,0,0,9024,9024,9024,9024,9024,9024,9024,9024,9024,9024,9024,9024,9024,9024,9024,0,9020,9020,9020,9020,0,0,0,0
0,0,0,0,0,0,0,0,0,9003,9003,0,9004,9004,9004,9004,9004,9004,9004,9004,9004,9004,9004,9004,9004,9004,9004,9004,9004,9004,9004,9004,0,9016,9016,9016,9016,9016,0,0,9024,9024,9024,9024,9024,9024,9024,9024,9024,9024,9024,9024,9024,9024,9024,0,0,0,0,0,0,0,0,0
0,9038,9038,9038,9038,9038,9038,0,0,9003,9003,0,9004,9004,9004,9004,9004,9004,9004,9004,9004,9004,9004,9004,9004,9004,9004,9004,9004,9004,9004,9004,0,9016,9016,9016,9016,9016,0,0,0,0,0,0,0,0,0,0,0,0,0,0,0,0,0,0,9019,9019,9019,9019,0,0,0,0
0,9038,9038,9038,9038,9038,9038,0,0,9003,9003,0,9004,9004,9004,9004,9004,9004,9004,9004,9004,9004,9004,9004,9004,9004,9004,9004,9004,9004,9004,9004,0,9016,9016,9016,9016,9016,0,0,9023,9023,9023,9023,9023,9023,9023,9023,9023,9023,9023,9023,9023,9023,9023,0,9019,9019,9019,9019,0,0,0,0
0,9038,0,0,0,9038,9038,0,0,9003,9003,0,0,0,0,0,0,0,0,0,0,0,9004,9004,9004,9004,9004,0,0,0,0,0,0,0,9016,9016,9016,9016,0,0,9023,9023,9023,9023,9023,9023,9023,9023,9023,9023,9023,9023,9023,9023,9023,0,9019,9019,9019,9019,0,0,0,0
0,9038,0,0,0,9038,9038,0,0,9003,9003,0,0,0,0,0,0,0,0,0,0,0,0,0,0,0,0,0,0,0,0,0,0,0,9016,9016,9016,9016,0,0,9023,9023,9023,9023,9023,9023,9023,9023,9023,9023,9023,9023,9023,9023,9023,0,9019,9019,9019,9019,0,0,0,0
0,0,0,0,0,0,0,0,0,9003,9003,9003,9003,9003,9003,0,0,9015,9015,9015,9015,0,9008,9008,9008,9008,9008,0,9012,9012,9012,9012,0,0,9016,9016,9016,9016,0,0,0,0,0,0,0,0,0,0,0,0,0,0,0,0,0,0,0,0,0,0,0,0,0,0
0,0,0,0,0,0,0,0,0,9003,9003,9003,9003,9003,9003,0,0,9015,9015,9015,9015,0,9008,9008,9008,9008,9008,0,9012,9012,9012,9012,0,0,9016,9016,9016,9016,0,0,9021,9021,9021,9021,0,9018,9018,9018,9018,9018,9018,9018,9018,9018,9018,9018,9018,9018,9018,9018,0,0,0,0
0,0,0,0,0,0,0,0,0,0,0,0,9003,9003,9003,0,0,9015,9015,9015,9015,0,9008,9008,9008,9008,9008,0,9012,9012,9012,9012,0,0,9016,9016,9016,9016,0,0,9021,9021,9021,9021,0,9018,9018,9018,9018,9018,9018,9018,9018,9018,9018,9018,9018,9018,9018,9018,0,0,0,0
0,0,0,0,0,0,0,0,0,0,0,0,0,0,0,0,0,9015,9015,9015,9015,0,9008,9008,9008,9008,9008,0,9012,9012,9012,9012,0,0,9016,9016,9016,9016,0,0,9021,9021,9021,9021,0,9018,9018,9018,9018,9018,9018,9018,9018,9018,9018,9018,9018,9018,9018,9018,0,0,0,0
0,9002,9002,0,9002,9002,9002,0,9002,9002,9002,0,9001,9001,9001,0,0,0,0,0,0,0,9008,9008,9008,9008,9008,0,0,0,0,0,0,0,9016,9016,9016,9016,0,0,9021,9021,9021,9021,0,9018,9018,9018,9018,9018,9018,9018,9018,9018,9018,9018,9018,9018,9018,9018,0,0,0,0
0,9002,9002,0,9002,9002,9002,0,9002,9002,9002,0,9001,9001,9001,0,0,9014,9014,9014,9014,0,9008,9008,9008,9008,9008,0,9011,9011,9011,9011,0,0,9016,9016,9016,9016,0,0,0,0,0,0,0,0,0,0,0,0,0,0,0,0,0,0,0,0,0,0,0,0,0,0
0,9002,9002,0,9002,9002,9002,0,9002,9002,9002,0,9001,9001,9001,0,0,9014,9014,9014,9014,0,9008,9008,9008,9008,9008,0,9011,9011,9011,9011,0,0,9016,9016,9016,9016,0,0,9022,9022,9022,9022,0,9017,9017,9017,9017,9017,9017,9017,9017,9017,9017,9017,9017,9017,9017,9017,0,0,0,0
0,9002,9002,0,0,0,0,0,0,0,0,0,9001,9001,9001,0,0,9014,9014,9014,9014,0,9008,9008,9008,9008,9008,0,9011,9011,9011,9011,0,0,9016,9016,9016,9016,0,0,9022,9022,9022,9022,0,9017,9017,9017,9017,9017,9017,9017,9017,9017,9017,9017,9017,9017,9017,9017,0,0,0,0
0,9002,9002,9002,9002,9002,9002,9002,9002,9002,9002,0,9001,9001,9001,0,0,9014,9014,9014,9014,0,9008,9008,9008,9008,9008,0,9011,9011,9011,9011,0,0,9016,9016,9016,9016,0,0,9022,9022,9022,9022,0,9017,9017,9017,9017,9017,9017,9017,9017,9017,9017,9017,9017,9017,9017,9017,0,0,0,0
0,9002,9002,9002,9002,9002,9002,9002,9002,9002,9002,0,9001,9001,9001,0,0,0,0,0,0,0,9008,9008,9008,9008,9008,0,0,0,0,0,0,0,9016,9016,9016,9016,0,0,0,0,0,0,0,0,0,0,0,0,0,0,0,0,0,0,0,0,0,0,0,0,0,0
0,9002,9002,9002,9002,9002,9002,9002,9002,9002,9002,0,9001,9001,9001,0,0,9013,9013,9013,9013,0,9008,9008,9008,9008,9008,0,9010,9010,9010,9010,0,0,9016,9016,9016,9016,0,0,0,0,0,0,0,0,0,0,0,0,9016,9016,9016,9016,9016,9016,0,0,0,0,0,0,0,0
0,9002,9002,0,0,0,0,0,0,0,0,0,9001,9001,9001,0,0,9013,9013,9013,9013,0,0,0,0,0,0,0,9010,9010,9010,9010,0,0,9016,9016,9016,9016,9016,9016,9016,9016,9016,9016,9016,9016,9016,9016,9016,9016,9016,9016,9016,9016,9016,9016,9016,9016,9016,9016,0,0,0,0
0,9002,9002,0,9002,9002,9002,0,9002,9002,9002,0,9001,9001,9001,0,0,9013,9013,9013,9013,0,9009,9009,9009,9009,9009,0,9010,9010,9010,9010,0,0,9016,9016,9016,9016,9016,9016,9016,9016,9016,9016,9016,9016,9016,9016,9016,9016,9016,9016,9016,9016,9016,9016,9016,9016,9016,9016,0,0,0,0
0,9002,9002,0,9002,9002,9002,0,9002,9002,9002,0,9001,9001,9001,0,0,9013,9013,9013,9013,0,9009,9009,9009,9009,9009,0,9010,9010,9010,9010,0,0,9016,9016,9016,9016,9016,9016,9016,9016,9016,9016,9016,9016,9016,9016,9016,9016,9016,9016,9016,9016,9016,9016,9016,9016,9016,9016,0,0,0,0
0,9002,9002,0,9002,9002,9002,0,9002,9002,9002,0,9001,9001,9001,0,0,9013,9013,9013,9013,0,9009,9009,9009,9009,9009,0,9010,9010,9010,9010,0,0,9016,9016,9016,9016,9016,9016,9016,9016,9016,9016,9016,9016,9016,9016,9016,9016,9016,9016,9016,9016,9016,9016,9016,9016,9016,9016,0,0,0,0
0,0,0,0,0,0,0,0,0,0,0,0,0,0,0,0,0,0,0,0,0,0,0,0,0,0,0,0,0,0,0,0,0,0,0,0,0,0,0,0,0,0,0,0,0,0,0,0,0,0,0,0,0,0,0,0,0,0,0,0,0,0,0,0
0,0,0,0,0,0,0,0,0,0,0,0,0,0,0,0,0,0,0,0,0,0,0,0,0,0,0,0,0,0,0,0,0,0,0,0,0,0,0,0,0,0,0,0,0,0,0,0,0,0,0,0,0,0,0,0,0,0,0,0,0,0,0,0
